abelmoschus: abelmoschuses
abramis: abramises
acanthocereus: acanthocereuses
acanthocybium: acanthocybiums
acanthophis: acanthophises
acanthurus: acanthuruses
acapulco: acapulcoes
achoerodus: achoeroduses
aconitum: aconitums
acorus: acoruses
acris: acrises
acrocarpus: acrocarpuses
acrocephalus: acrocephaluses
acroclinium: acrocliniums
acrostichum: acrostichums
actiniopteris: actiniopterises
actinomeris: actinomerises
actitis: actitises
actium: actiums
adenium: adeniums
adiantum: adiantums
adonis: adonises
adrianopolis: adrianopolises
aegypius: aegypiuses
aegyptopithecus: aegyptopithecuses
aengus: aenguses
aeolis: aeolises
aeolus: aeoluses
aeonium: aeoniums
aeschylus: aeschyluses
aesculapius: aesculapiuses
aesculus: aesculuses
aetobatus: aetobatuses
aframomum: aframomums
afrocarpus: afrocarpusses
agapornis: agapornises
agaricus: agaricuses
agathis: agathises
agdistis: agdistises
agelaius: agelaiuses
agonus: agonuses
agriocharis: agriocharises
agrobacterium: agrobacteriums
agrostis: agrostises
ahriman: ahrimans
aidoneus: aidoneuses
ailurus: ailuruses
alabaman: alabamans
alamo: alamoes
albatrellus: albatrelluses
albugo: albugoes
alcaeus: alcaeuses
alcedo: alcedoes
alcelaphus: alcelaphuses
alectis: alectises
alectoris: alectorises
alepisaurus: alepisauruses
aleppo: aleppoes
aletris: aletrises
algeripithecus: algeripithecuses
allium: alliums
alnus: alnuses
alopecurus: alopecuruses
alopius: alopiuses
alyssum: alyssums
amaranthus: amaranthuses
amblyrhynchus: amblyrhynchuses
ameiurus: ameiuruses
amianthum: amianthums
amman: ammans
ammotragus: ammotraguses
amoy: amoys
amygdalus: amygdaluses
anabrus: anabruses
anacardium: anacardiums
anacyclus: anacycluses
anagallis: anagallises
anagyris: anagyrises
anaphalis: anaphalises
anastomus: anastomuses
ancylus: ancyluses
andricus: andricuses
anemopsis: anemopsises
anethum: anethums
angelus: angeluses
angraecum: angraecums
anguis: anguises
angus: anguses
anigozanthus: anigozanthuses
anisotremus: anisotremuses
annapolis: annapolises
anoectochilus: anoectochiluses
anolis: anolises
anopheles: anopheles
anser: anseres
antananarivo: antananarivoes
anthemis: anthemises
anthericum: anthericums
anthidium: anthidiums
anthonomus: anthonomuses
anthriscus: anthriscuses
anthus: anthuses
anthyllis: anthyllises
antido: antidoes
antigonus: antigonuses
antirrhinum: antirrhinums
antrozous: antrozouses
antum: antums
anubis: anubises
aotus: aotuses
aphis: aphises
apis: apises
aplectrum: aplectrums
apocynum: apocynums
apodemus: apodemuses
aporocactus: aporocactuses
apus: apuses
aquarius: aquariuses
ar: ares
arabis: arabises
arachis: arachises
aramus: aramuses
aranea: araneae
araneus: araneuses
arapaho: arapahoes
arceuthobium: arceuthobiums
archilochus: archilochuses
archosargus: archosarguses
arctictis: arctictises
arctium: arctiums
arctocebus: arctocebuses
arctocephalus: arctocephaluses
arctotis: arctotises
arcturus: arcturuses
argus: arguses
argusianus: argusianuses
argynnis: argynnises
argyranthemum: argyranthemums
argyroxiphium: argyroxiphiums
arilus: ariluses
ariocarpus: ariocarpuses
arisarum: arisarums
aristarchus: aristarchuses
arius: ariuses
armadillidium: armadillidiums
arminius: arminiuses
arno: arnoes
arnoseris: arnoserises
arrhenatherum: arrhenatherums
artamus: artamuses
artemis: artemises
arthropteris: arthropterises
artocarpus: artocarpuses
artois: artoises
arulo: aruloes
arundo: arundoes
asarum: asarums
ascaphus: ascaphuses
ascaris: ascarises
ascophyllum: ascophyllums
asio: asioes
aspalathus: aspalathuses
aspergillus: aspergilluses
asphodelus: asphodeluses
aspidiotus: aspidiotuses
aspis: aspises
asplenium: aspleniums
astacus: astacuses
astragalus: astragaluses
astreus: astreuses
astronium: astroniums
atherinopsis: atherinopsises
atherurus: atheruruses
athrotaxis: athrotaxises
athyrium: athyriums
atrichornis: atrichornises
atticus: atticuses
augustus: augustuses
aulacorhyncus: aulacorhyncuses
aulostomus: aulostomuses
auriparus: auriparuses
australopithecus: australopithecuses
austrocedrus: austrocedruses
austrotaxus: austrotaxuses
automeris: automerises
azaleastrum: azaleastrums
ban: bani
bmus: bmuses
baccharis: baccharises
bacchus: bacchuses
balanus: balanuses
bamako: bamakoes
basiliscus: basiliscuses
bassariscus: bassariscuses
bathyergus: bathyerguses
batis: batises
bauhaus: bauhauses
beaujolais: beaujolaises
beckley: beckleys
belarus: belaruses
belgium: belgiums
bellis: bellises
bennettitis: bennettitises
berberis: berberises
berkeley: berkeleys
bigfoot: bigfoots
bioko: biokoes
bitis: bitises
blaberus: blaberuses
blechnum: blechnums
blennius: blenniuses
blissus: blissuses
bogey: bogeys
bolbitis: bolbitises
boletellus: boletelluses
boletus: boletuses
bombay: bombays
bombus: bombuses
borago: boragoes
borassus: borassuses
borneo: borneoes
borodino: borodinoes
boselaphus: boselaphuses
bosporus: bosporuses
botaurus: botauruses
botrychium: botrychiums
brachinus: brachinuses
bradypus: bradypuses
brahman: brahmans
breiz: breizzes
bris: brises
broadway: broadways
bromus: bromuses
brosmius: brosmiuses
bruchus: bruchuses
brutus: brutuses
bubalus: bubaluses
bubo: buboes
bubulcus: bubulcuses
buffalo: buffaloes
bungarus: bungaruses
buphthalmum: buphthalmums
burhinus: burhinuses
buteo: buteoes
buxus: buxuses
byelarus: byelaruses
byzantium: byzantiums
cis: cises
cacajao: cacajaoes
cacicus: cacicuses
cadiz: cadizzes
cairo: cairoes
cajanus: cajanuses
calamagrostis: calamagrostises
calamus: calamuses
calidris: calidrises
callicebus: callicebuses
calliophis: calliophises
callisaurus: callisauruses
callistephus: callistephuses
callisto: callistoes
callitris: callitrises
callophis: callophises
callorhinus: callorhinuses
calocarpum: calocarpums
calocedrus: calocedruses
calochortus: calochortuses
calophyllum: calophyllums
calycanthus: calycanthuses
calycophyllum: calycophyllums
cambarus: cambaruses
camelus: cameluses
campephilus: campephiluses
camponotus: camponotuses
camptosorus: camptosoruses
campyloneurum: campyloneurums
campylorhynchus: campylorhynchuses
canangium: canangiums
canis: canises
cantharellus: cantharelluses
caporetto: caporettoes
capparis: capparises
capreolus: capreoluses
capricornis: capricornises
capricornus: capricornuses
caprimulgus: caprimulguses
carassius: carassiuses
carboloy: carboloys
carboniferous: carboniferouses
carcharhinus: carcharhinuses
cardiospermum: cardiospermums
cardium: cardiums
carduelis: carduelises
carduus: carduuses
carphophis: carphophises
carpinus: carpinuses
carpobrotus: carpobrotuses
carpodacus: carpodacuses
carthamus: carthamuses
casmerodius: casmerodiuses
cassius: cassiuses
castanopsis: castanopsises
castanospermum: castanospermums
casuarius: casuariuses
catasetum: catasetums
catharanthus: catharanthuses
cathay: cathays
catoptrophorus: catoptrophoruses
catostomus: catostomuses
caucasus: caucasuses
caulophyllum: caulophyllums
cebuano: cebuanoes
cedrus: cedruses
celastrus: celastruses
celtis: celtises
cenchrus: cenchruses
centaurium: centauriums
centaurus: centauruses
centranthus: centranthuses
centrocercus: centrocercuses
centrolobium: centrolobiums
centropomus: centropomuses
centropristis: centropristises
centropus: centropuses
centunculus: centunculuses
cephalopterus: cephalopteruses
cephalotaxus: cephalotaxuses
cephalotus: cephalotuses
cepheus: cepheuses
cepphus: cepphuses
cerastium: cerastiums
ceratitis: ceratitises
ceratopetalum: ceratopetalums
ceratophyllum: ceratophyllums
ceratopteris: ceratopterises
ceratotherium: ceratotheriums
cerberus: cerberuses
cercidiphyllum: cercidiphyllums
cercidium: cercidiums
cercis: cercises
cercocebus: cercocebuses
cercopithecus: cercopithecuses
cereus: cereuses
cervus: cervuses
cestida: cestidae
cestrum: cestrums
cestum: cestums
cetorhinus: cetorhinuses
chablis: chablises
chaenopsis: chaenopsises
chaetodipterus: chaetodipteruses
chalcis: chalcises
chamaecyparis: chamaecyparises
chamaecytisus: chamaecytisuses
chamaeleo: chamaeleoes
chamaemelum: chamaemelums
chardonnay: chardonnays
charolais: charolaises
charon: chara
charybdis: charybdises
cheiranthus: cheiranthuses
chelidonium: chelidoniums
chemakum: chemakums
chenopodium: chenopodiums
cheremis: cheremises
chicago: chicagoes
chilomeniscus: chilomeniscuses
chilomycterus: chilomycteruses
chilopsis: chilopsises
chimakum: chimakums
chimariko: chimarikoes
chimborazo: chimborazoes
chimonanthus: chimonanthuses
chingpo: chingpoes
chionanthus: chionanthuses
chirocephalus: chirocephaluses
chironomus: chironomuses
chlamydosaurus: chlamydosauruses
chlamyphorus: chlamyphoruses
chloranthus: chloranthuses
chloris: chlorises
chlorococcum: chlorococcums
chlorophis: chlorophises
chlorophoneus: chlorophoneuses
choeronycteris: choeronycterises
choloepus: choloepuses
chondrus: chondruses
chordospartium: chordospartiums
choriotis: choriotises
chorizagrotis: chorizagrotises
chrysobalanus: chrysobalanuses
chrysochloris: chrysochlorises
chrysolepis: chrysolepises
chrysolophus: chrysolophuses
chrysophyllum: chrysophyllums
chrysopsis: chrysopsises
chrysosplenium: chrysospleniums
chrysothamnus: chrysothamnuses
cibotium: cibotiums
cichorium: cichoriums
cinclus: cincluses
cinnamomum: cinnamomums
cipro: ciproes
circaetus: circaetuses
circus: circuses
cirsium: cirsiums
cistothorus: cistothoruses
cistus: cistuses
citellus: citelluses
citroncirus: citronciruses
citrullus: citrulluses
cladorhyncus: cladorhyncuses
cladrastis: cladrastises
clathrus: clathruses
clinopodium: clinopodiums
clotho: clothoes
clovis: clovises
cnemidophorus: cnemidophoruses
cnicus: cnicuses
cnidoscolus: cnidoscoluses
cocculus: cocculuses
coccyzus: coccyzuses
cochlearius: cochleariuses
cockney: cockneys
cocus: cocuses
cocytus: cocytuses
codiaeum: codiaeums
coeloglossum: coeloglossums
colchicum: colchicums
colchis: colchises
colinus: colinuses
colombo: colomboes
colorado: coloradoes
columbus: columbuses
conepatus: conepatuses
confucius: confuciuses
congo: congoes
conilurus: coniluruses
conium: coniums
connarus: connaruses
conocarpus: conocarpuses
conoclinium: conocliniums
conopodium: conopodiums
conospermum: conospermums
conoy: conoys
contopus: contopuses
conuropsis: conuropsises
copernicus: copernicuses
coprinus: coprinuses
coptis: coptises
cordylus: cordyluses
coregonus: coregonuses
coriandrum: coriandrums
cornus: cornuses
cortez: cortezzes
corticium: corticiums
cortinarius: cortinariuses
corvus: corvuses
corydalis: corydalises
corydalus: corydaluses
corylopsis: corylopsises
corylus: coryluses
cosmocampus: cosmocampuses
cotinus: cotinuses
cottus: cottuses
cracticus: cracticuses
crataegus: crataeguses
crepis: crepises
cretaceous: cretaceouses
cricetus: cricetuses
crius: criuses
crocodilus: crocodiluses
crocodylus: crocodyluses
cronartium: cronartiums
cronus: cronuses
crotalus: crotaluses
crotaphytus: crotaphytuses
cryptobranchus: cryptobranchuses
cryptocercus: cryptocercuses
cryptotis: cryptotises
cuculus: cuculuses
cucumis: cucumises
cuminum: cuminums
cuniculus: cuniculuses
cupressus: cupressuses
cursorius: cursoriuses
cyamopsis: cyamopsises
cyamus: cyamuses
cyclophorus: cyclophoruses
cyclops: cyclops
cyclopterus: cyclopteruses
cyclosorus: cyclosoruses
cygnus: cygnuses
cynocephalus: cynocephaluses
cynoglossum: cynoglossums
cynopterus: cynopteruses
cyperus: cyperuses
cyprinus: cyprinuses
cypripedium: cypripediums
cyprus: cypruses
cyrtomium: cyrtomiums
cystopteris: cystopterises
cytisus: cytisuses
czech: czechs
dmus: dmuses
dacelo: daceloes
dacrycarpus: dacrycarpuses
dacrydium: dacrydiums
dactylis: dactylises
dactyloctenium: dactylocteniums
dactylopius: dactylopiuses
dactylopterus: dactylopteruses
daedalus: daedaluses
daffo: daffoes
dahomey: dahomeys
damaliscus: damaliscuses
damascus: damascuses
dana: danae
danaus: danauses
dasyatis: dasyatises
dasypus: dasypuses
dasyurus: dasyuruses
daucus: daucuses
daypro: dayproes
decapterus: decapteruses
delicious: deliciouses
delphinapterus: delphinapteruses
delphinus: delphinuses
demetrius: demetriuses
dendraspis: dendraspises
dendroaspis: dendroaspises
dendrocalamus: dendrocalamuses
dendroctonus: dendroctonuses
dendrolagus: dendrolaguses
desmanthus: desmanthuses
desmidium: desmidiums
desmodium: desmodiums
desmodus: desmoduses
desmograthus: desmograthuses
dewey: deweys
diadophis: diadophises
dianthus: dianthuses
dicranopteris: dicranopterises
dicranum: dicranums
dictamnus: dictamnuses
didelphis: didelphises
dido: didoes
diegueno: dieguenoes
dimocarpus: dimocarpuses
dinornis: dinornises
dionysus: dionysuses
diplopterygium: diplopterygiums
diplotaxis: diplotaxises
dipsacus: dipsacuses
dipsosaurus: dipsosauruses
dipus: dipuses
dis: disses
doberman: dobermans
dolichotis: dolichotises
doomsday: doomsdays
doris: dorises
doronicum: doronicums
dorotheanthus: dorotheanthuses
doryopteris: doryopterises
dovyalis: dovyalises
draco: dracoes
dracocephalum: dracocephalums
dracunculus: dracunculuses
drepanis: drepanises
dreyfus: dreyfuses
dromaius: dromaiuses
drosophyllum: drosophyllums
drymoglossum: drymoglossums
dryopithecus: dryopithecuses
dryopteris: dryopterises
durio: durioes
dy: dys
dyaus: dyauses
dysdercus: dysdercuses
ebro: ebroes
ecballium: ecballiums
echeneis: echeneises
echinocereus: echinocereuses
echium: echiums
elaeagnus: elaeagnuses
elaeis: elaeises
elaeocarpus: elaeocarpuses
elagatis: elagatises
elanus: elanuses
elaphurus: elaphuruses
eleocharis: eleocharises
elephantopus: elephantopuses
eleutherodactylus: eleutherodactyluses
elymus: elymuses
elysium: elysiums
embothrium: embothriums
empetrum: empetrums
enceliopsis: enceliopsises
engraulis: engraulises
ensis: ensises
enterobius: enterobiuses
enterolobium: enterolobiums
ephemerida: ephemeridae
ephippiorhynchus: ephippiorhynchuses
epicurus: epicuruses
epidendrum: epidendrums
epilobium: epilobiums
epimedium: epimediums
epimetheus: epimetheuses
epinephelus: epinepheluses
epipactis: epipactises
epipremnum: epipremnums
eptesicus: eptesicuses
equetus: equetuses
equisetum: equisetums
equus: equuses
eragrostis: eragrostises
eranthis: eranthises
erasmus: erasmuses
erato: eratoes
erebus: erebuses
erianthus: erianthuses
erignathus: erignathuses
erinaceus: erinaceuses
eriophorum: eriophorums
eriophyllum: eriophyllums
eris: erises
erithacus: erithacuses
erodium: erodiums
eryngium: eryngiums
erysimum: erysimums
erythrocebus: erythrocebuses
erythronium: erythroniums
erythroxylum: erythroxylums
eschrichtius: eschrichtiuses
esperantido: esperantidoes
esperanto: esperantoes
etropus: etropuses
eucinostomus: eucinostomuses
euonymus: euonymuses
eupatorium: eupatoriums
euphagus: euphaguses
euphractus: euphractuses
euproctis: euproctises
eurotium: eurotiums
euthynnus: euthynnuses
exacum: exacums
exodus: exoduses
ezo: ezoes
fagopyrum: fagopyrums
fagus: faguses
falcatifolium: falcatifoliums
falco: falcoes
faraday: faradays
fargo: fargoes
faunus: faunuses
faustus: faustuses
felis: felises
ferocactus: ferocactuses
ficus: ficus
flaminius: flaminiuses
floreal: floreales
foeniculum: foeniculums
fontenoy: fontenoys
formicarius: formicariuses
fortaz: fortazzes
fraxinus: fraxinuses
fresno: fresnoes
frey: freys
friday: fridays
fuego: fuegoes
fulmarus: fulmaruses
fundulus: funduluses
furnarius: furnariuses
fusanus: fusanuses
fuscoboletinus: fuscoboletinuses
gadus: gaduses
galeocerdo: galeocerdoes
galeopsis: galeopsises
galeorhinus: galeorhinuses
galileo: galileoes
galium: galiums
gallinago: gallinagoes
gallirallus: galliralluses
galloway: galloways
gallus: galluses
garrulus: garruluses
gasherbrum: gasherbrums
gasterophilus: gasterophiluses
gasterosteus: gasterosteuses
gastroboletus: gastroboletuses
gavialis: gavialises
geastrum: geastrums
gelsemium: gelsemiums
gempylus: gempyluses
gentianopsis: gentianopsises
genyonemus: genyonemuses
geoglossum: geoglossums
geophilus: geophiluses
geothlypis: geothlypises
gerbillus: gerbilluses
german: germans
gerrhonotus: gerrhonotuses
geum: geums
glaucium: glauciums
glis: glises
gnaphalium: gnaphaliums
gobio: gobioes
gomphotherium: gomphotheriums
goniopteris: goniopterises
gonorhynchus: gonorhynchuses
gopherus: gopheruses
gorgonocephalus: gorgonocephaluses
gorkiy: gorkiys
gossypium: gossypiums
grammatophyllum: grammatophyllums
granicus: granicuses
graptophyllum: graptophyllums
greensboro: greensboroes
gropius: gropiuses
grus: gruses
guaiacum: guaiacums
guernsey: guernseys
gulo: guloes
guy: guys
gymnadeniopsis: gymnadeniopsises
gymnasium: gymnasiums
gymnelis: gymnelises
gymnocalycium: gymnocalyciums
gymnocarpium: gymnocarpiums
gymnocladus: gymnocladuses
gymnopilus: gymnopiluses
gymnosporangium: gymnosporangiums
gypaetus: gypaetuses
hachiman: hachimans
haemanthus: haemanthuses
haematopus: haematopuses
haematoxylum: haematoxylums
haemodorum: haemodorums
haemopis: haemopises
haemoproteus: haemoproteuses
haliaeetus: haliaeetuses
haliotis: haliotises
halocarpus: halocarpuses
hamamelidanthum: hamamelidanthums
hamamelis: hamamelises
haman: hamans
hanuman: hanumans
haplopappus: haplopappuses
hedysarum: hedysarums
helenium: heleniums
helichrysum: helichrysums
heliothis: heliothises
helipterum: helipterums
helix: helices
helleborus: helleboruses
helotium: helotiums
hemachatus: hemachatuses
hemerocallis: hemerocallises
hemigalus: hemigaluses
hemigrammus: hemigrammuses
hemingway: hemingways
hemipteronatus: hemipteronatuses
hemitripterus: hemitripteruses
hephaestus: hephaestuses
heracleum: heracleums
herculaneum: herculaneums
herodotus: herodotuses
hertz: hertz
hesperis: hesperises
heterocephalus: heterocephaluses
heteroscelus: heterosceluses
hexalectris: hexalectrises
hexanchus: hexanchuses
hieracium: hieraciums
himantoglossum: himantoglossums
himantopus: himantopuses
hippocrepis: hippocrepises
hippoglossus: hippoglossuses
hippotragus: hippotraguses
hipsurus: hipsuruses
hirudo: hirudoes
hirundo: hirundoes
hogmanay: hogmanays
hokkaido: hokkaidoes
holcus: holcuses
holocentrus: holocentruses
homarus: homaruses
hondo: hondoes
hordeum: hordeums
horus: horuses
hugo: hugoes
humulus: humuluses
huxley: huxleys
hydnocarpus: hydnocarpuses
hydnum: hydnums
hydrastis: hydrastises
hydrocharis: hydrocharises
hydrochoerus: hydrochoeruses
hydrodamalis: hydrodamalises
hydrophyllum: hydrophyllums
hydrus: hydruses
hyemoschus: hyemoschuses
hygrophorus: hygrophoruses
hylocereus: hylocereuses
hymenophyllum: hymenophyllums
hyoscyamus: hyoscyamuses
hypentelium: hypenteliums
hypericum: hypericums
hypochaeris: hypochaerises
hypochoeris: hypochoerises
hypopachus: hypopachuses
hypoxis: hypoxises
hyracotherium: hyracotheriums
hyssopus: hyssopuses
iapetus: iapetuses
iberis: iberises
icarus: icaruses
ictalurus: ictaluruses
icterus: icteruses
ictiobus: ictiobuses
idaho: idahoes
ido: idoes
illecebrum: illecebrums
illicium: illiciums
illinois: illinoises
inachis: inachises
indianapolis: indianapolises
indus: induses
ingerman: ingermans
io: ioes
ioway: ioways
ipsus: ipsuses
iroquois: iroquoises
isatis: isatises
isis: isises
isopyrum: isopyrums
issus: issuses
istiophorus: istiophoruses
isurus: isuruses
iwo: iwoes
ixobrychus: ixobrychuses
j: jes
jaculus: jaculuses
jahvey: jahveys
janus: januses
jasminum: jasminums
javanthropus: javanthropuses
jerez: jerezzes
jericho: jerichoes
jersey: jerseys
jinghpo: jinghpoes
juarez: juarezzes
juncus: juncuses
juniperus: juniperuses
juno: junoes
kakemono: kakemonoes
katsuwonus: katsuwonuses
kenyapithecus: kenyapithecuses
khartoum: khartoums
khirghiz: khirghizzes
kilimanjaro: kilimanjaroes
kobus: kobuses
kotoko: kotokoes
kovno: kovnoes
krakatao: krakataoes
kuroshio: kuroshioes
kyoto: kyotoes
kyphosus: kyphosuses
lox: lox
laburnum: laburnums
laccopetalum: laccopetalums
lachnolaimus: lachnolaimuses
lactarius: lactariuses
lagarostrobus: lagarostrobuses
lagidium: lagidiums
lagopus: lagopuses
lagostomus: lagostomuses
lambis: lambises
lamium: lamiums
lampris: lamprises
lampropeltis: lampropeltises
lanius: laniuses
lanthanotus: lanthanotuses
lasiurus: lasiuruses
lastreopsis: lastreopsises
lathyrus: lathyruses
latium: latiums
latrodectus: latrodectuses
laudo: laudoes
laurus: lauruses
lazarus: lazaruses
lazio: lazioes
leakey: leakeys
leccinum: leccinums
leibniz: leibnizzes
leiophyllum: leiophyllums
lemaireocereus: lemaireocereuses
lemmus: lemmuses
lentinus: lentinuses
leonardo: leonardoes
leonotis: leonotises
leontocebus: leontocebuses
leontopodium: leontopodiums
leonurus: leonuruses
lepanto: lepantoes
lepidium: lepidiums
lepidocybium: lepidocybiums
lepidothamnus: lepidothamnuses
lepisosteus: lepisosteuses
lepomis: lepomises
leptodactylus: leptodactyluses
leptoglossus: leptoglossuses
leptopteris: leptopterises
leptoptilus: leptoptiluses
lepus: lepuses
lesotho: lesothoes
leto: letoes
leucanthemum: leucanthemums
leuciscus: leuciscuses
levisticum: levisticums
leviticus: leviticuses
leymus: leymuses
liatris: liatrises
libocedrus: libocedruses
librium: libriums
ligustrum: ligustrums
lilium: liliums
limenitis: limenitises
limnobium: limnobiums
limnodromus: limnodromuses
limonium: limoniums
limpopo: limpopoes
limulus: limuluses
linanthus: linanthuses
linnaeus: linnaeuses
liparis: liparises
liposcelis: liposcelises
lithocarpus: lithocarpuses
lithospermum: lithospermums
litocranius: litocraniuses
llullaillaco: llullaillacoes
lolium: loliums
lolo: loloes
lonchocarpus: lonchocarpuses
lophius: lophiuses
lopholatilus: lopholatiluses
lophophorus: lophophoruses
loranthus: loranthuses
lotus: lotuses
lufengpithecus: lufengpithecuses
lumpenus: lumpenuses
luo: luoes
lupinus: lupinuses
lupus: lupuses
lutjanus: lutjanuses
luvarus: luvaruses
lycium: lyciums
lycopersicum: lycopersicums
lycopodium: lycopodiums
lycopus: lycopuses
lyginopteris: lyginopterises
lygodium: lygodiums
lygus: lyguses
lyonnais: lyonnaises
lyrurus: lyruruses
lysichitum: lysichitums
lysimachus: lysimachuses
lythrum: lythrums
macao: macaoes
macrodactylus: macrodactyluses
macropus: macropuses
macrothelypteris: macrothelypterises
macrotis: macrotises
maianthemum: maianthemums
malabo: malaboes
malacothamnus: malacothamnuses
malaxis: malaxises
malay: malays
mallotus: mallotuses
malmo: malmoes
malopterurus: malopteruruses
malthus: malthuses
malto: maltoes
malvastrum: malvastrums
malvaviscus: malvaviscera
mammuthus: mammuthuses
mandalay: mandalays
mandrillus: mandrilluses
maputo: maputoes
maquis: maquises
maraco: maracoes
marasmius: marasmiuses
marengo: marengoes
marrubium: marrubiums
masticophis: masticophises
mastigoproctus: mastigoproctuses
mauritius: mauritiuses
may: mays
mayday: maydays
mckinley: mckinleys
meconopsis: meconopsises
medicago: medicagoes
megalobatrachus: megalobatrachuses
megapodius: megapodiuses
megatherium: megatheriums
melampodium: melampodiums
melanogrammus: melanogrammuses
melanoplus: melanopluses
melanotis: melanotises
meleagris: meleagrises
melicoccus: melicoccuses
melocactus: melocactuses
melophagus: melophaguses
melopsittacus: melopsittacuses
melursus: melursuses
memphis: memphises
meniscium: menisciums
menispermum: menispermums
menticirrhus: menticirrhuses
menura: menurae
mephitis: mephitises
mercedario: mercedarioes
mercurialis: mercurialises
mergus: merguses
merlangus: merlanguses
merluccius: merlucciuses
mesembryanthemum: mesembryanthemums
mesocricetus: mesocricetuses
mespilus: mespiluses
mexico: mexicoes
michelangelo: michelangeloes
mickey: mickeys
microcentrum: microcentrums
micrococcus: micrococcuses
micropterus: micropteruses
microsorium: microsoriums
microsporum: microsporums
microstomus: microstomuses
microtus: microtuses
micrurus: micruruses
midway: midways
milano: milanoes
milvus: milvuses
mimus: mimuses
mindoro: mindoroes
minneapolis: minneapolises
mirabilis: mirabilises
mnium: mniums
mo: moes
mogadiscio: mogadiscioes
molech: molechs
moloch: molochs
molothrus: molothruses
momotus: momotuses
momus: momuses
monaco: monacoes
monario: monarioes
monday: mondays
monocanthus: monocanthuses
monochamus: monochamuses
monomorium: monomoriums
monsieur: messieurs
montenegro: montenegroes
montevideo: montevideoes
morpheus: morpheuses
morus: moruses
moschus: moschuses
mulatto: mulattoes
mullus: mulluses
muntiacus: muntiacuses
murray: murrays
mus: muses
muscardinus: muscardinuses
mustelus: musteluses
mutinus: mutinuses
myopus: myopuses
myosotis: myosotises
myotis: myotises
myriophyllum: myriophyllums
myrmecobius: myrmecobiuses
myrrhis: myrrhises
myrtillocactus: myrtillocactuses
myrtus: myrtuses
mytilus: mytiluses
myxocephalus: myxocephaluses
nabalus: nabaluses
nacimiento: nacimientoes
naemorhedus: naemorheduses
narcissus: narcissus
narthecium: nartheciums
nasalis: nasalises
nasturtium: nasturtiums
navaho: navahoes
navajo: navajoes
navarino: navarinoes
nebo: neboes
necturus: necturuses
negro: negroes
nelumbo: nelumboes
neoceratodus: neoceratoduses
neohygrophorus: neohygrophoruses
neolentinus: neolentinuses
neosho: neoshoes
nephelium: nepheliums
nephrolepis: nephrolepises
nereus: nereuses
nerium: neriums
nerthus: nerthuses
neurotrichus: neurotrichuses
nevis: nevises
niamey: niameys
nigroporus: nigroporuses
nimravus: nimravuses
nintoo: nintooes
no: noes
norman: normans
norway: norways
notechis: notechises
notemigonus: notemigonuses
nothofagus: nothofaguses
notophthalmus: notophthalmuses
notoryctus: notoryctuses
notropis: notropises
numenius: numeniuses
nycticebus: nycticebuses
nymphalis: nymphalises
nymphicus: nymphicuses
oceanus: oceanuses
ocimum: ocimums
ocyurus: ocyuruses
odobenus: odobenuses
odocoileus: odocoileuses
odontaspis: odontaspises
odontophorus: odontophoruses
odysseus: odysseuses
odyssey: odysseys
oecanthus: oecanthuses
oedipus: oedipuses
oedogonium: oedogoniums
oengus: oenguses
oestrus: oestruses
ofo: ofoes
ohio: ohioes
ojibway: ojibways
oligoporus: oligoporuses
olympus: olympuses
oman: omans
omdurman: omdurmans
omphalotus: omphalotuses
onchorynchus: onchorynchuses
oniscus: oniscuses
onobrychis: onobrychises
ononis: ononises
onopordum: onopordums
onosmodium: onosmodiums
ontario: ontarioes
onychium: onychiums
ophioglossum: ophioglossums
ophiophagus: ophiophaguses
ophisaurus: ophisauruses
ophiurida: ophiuridae
opisthocomus: opisthocomuses
optez: optezzes
orcinus: orcinuses
orcus: orcuses
orectolobus: orectolobuses
oreopteris: oreopterises
orinoco: orinocoes
oriolus: orioluses
orlando: orlandoes
orleanais: orleanaises
ornithogalum: ornithogalums
ornithorhynchus: ornithorhynchuses
orontium: orontiums
orpheus: orpheuses
ortalis: ortalises
orthopristis: orthopristises
orthotomus: orthotomuses
orudis: orudises
orycteropus: orycteropuses
oryctolagus: oryctolaguses
oryzopsis: oryzopsises
osiris: osirises
oslo: osloes
osmanthus: osmanthuses
osmerus: osmeruses
ostryopsis: ostryopsises
otis: otises
oto: otoes
otus: otuses
ouranopithecus: ouranopithecuses
ovis: ovises
oxybelis: oxybelises
oxydendrum: oxydendrums
oxylebius: oxylebiuses
oxytropis: oxytropises
oxyuranus: oxyuranuses
ozonium: ozoniums
ozothamnus: ozothamnuses
pablum: pablums
pachyrhizus: pachyrhizuses
pagellus: pagelluses
pagophilus: pagophiluses
pagrus: pagruses
pagurus: paguruses
palaquium: palaquiums
palermo: palermoes
palinurus: palinuruses
paliurus: paliuruses
pamlico: pamlicoes
panicum: panicums
panonychus: panonychuses
paphiopedilum: paphiopedilums
papio: papioes
paprilus: papriluses
paradoxurus: paradoxuruses
paraguay: paraguays
paramaribo: paramariboes
paranthropus: paranthropuses
parasitaxus: parasitaxuses
parathelypteris: parathelypterises
paris: parises
parnassus: parnassuses
parochetus: parochetuses
parrotiopsis: parrotiopsises
parthenium: partheniums
parthenocissus: parthenocissuses
parus: paruses
pasch: paschs
pashto: pashtoes
passero: passeroes
pasto: pastoes
patavium: pataviums
pavo: pavoes
paxto: paxtoes
pediculus: pediculuses
pedilanthus: pedilanthuses
pediocactus: pediocactuses
pedionomus: pedionomuses
pegasus: pegasuses
pelargonium: pelargoniums
pelecanus: pelecanuses
peleus: peleuses
peloponnesus: peloponnesuses
peltiphyllum: peltiphyllums
peneus: peneuses
penicillium: penicilliums
pennisetum: pennisetums
pericallis: pericallises
peridinium: peridiniums
periophthalmus: periophthalmuses
peripatopsis: peripatopsises
perisoreus: perisoreuses
permalloy: permalloys
pernambuco: pernambucoes
pernis: pernises
perodicticus: perodicticuses
perognathus: perognathuses
peromyscus: peromyscuses
persepolis: persepolises
perseus: perseuses
pesach: pesachs
petaurus: petauruses
petrocoptis: petrocoptises
petroselinum: petroselinums
phacochoerus: phacochoeruses
phalaenopsis: phalaenopsises
phalaenoptilus: phalaenoptiluses
phalangium: phalangiums
phalaris: phalarises
phalaropus: phalaropuses
pharomacrus: pharomacruses
pharsalus: pharsaluses
phaseolus: phaseoluses
phasianus: phasianuses
phasmida: phasmidae
phegopteris: phegopterises
philaenus: philaenuses
philomachus: philomachuses
phlebodium: phlebodiums
phlebotomus: phlebotomuses
phleum: phleums
phoebus: phoebuses
phoenicophorium: phoenicophoriums
phoeniculus: phoeniculuses
phoenicurus: phoenicuruses
pholis: pholises
phoxinus: phoxinuses
phragmipedium: phragmipediums
phthirius: phthiriuses
phthirus: phthiruses
phyllitis: phyllitises
phyllium: phylliums
phyllocladus: phyllocladuses
phylloporus: phylloporuses
phyllorhynchus: phyllorhynchuses
phylloscopus: phylloscopuses
phyllostomus: phyllostomuses
physalis: physalises
picasso: picassoes
picris: picrises
picumnus: picumnuses
picus: picuses
pieris: pierises
pineus: pineuses
pinguinus: pinguinuses
pinus: pinuses
pipilo: pipiloes
pipistrellus: pipistrelluses
pipturus: pipturuses
pissis: pissises
pithecanthropus: pithecanthropuses
pithecellobium: pithecellobiums
pithecolobium: pithecolobiums
pituophis: pituophises
plagianthus: plagianthuses
planococcus: planococcuses
plantago: plantagoes
plassey: plasseys
platanus: platanuses
plato: platoes
platycerium: platyceriums
platylobium: platylobiums
platymiscium: platymisciums
platypoecilus: platypoeciluses
plautus: plautuses
plecotus: plecotuses
plesianthropus: plesianthropuses
pleurosorus: pleurosoruses
pleurotus: pleurotuses
plicatoperipatus: plicatoperipatuses
ploceus: ploceuses
pluteus: pluteuses
pluto: plutoes
pluvialis: pluvialises
pluvianus: pluvianuses
po: poes
podargus: podarguses
podilymbus: podilymbuses
podocarpus: podocarpuses
podophyllum: podophyllums
poecilocapsus: poecilocapsuses
pokomo: pokomoes
polaris: polarises
pollachius: pollachiuses
polyangium: polyangiums
polyborus: polyboruses
polycirrus: polycirruses
polydactylus: polydactyluses
polyergus: polyerguses
polygonatum: polygonatums
polygonum: polygonums
polypodium: polypodiums
polyporus: polyporuses
polystichum: polystichums
pomacanthus: pomacanthus
pomacentrus: pomacentruses
pomaderris: pomaderrises
pomatomus: pomatomuses
pomolobus: pomolobuses
pomoxis: pomoxises
pompey: pompeys
poncirus: ponciruses
pongo: pongoes
pontus: pontuses
populus: populuses
porcellio: porcellioes
poronotus: poronotuses
porphyrio: porphyrioes
portunus: portunuses
potamophis: potamophises
poterium: poteriums
potorous: potorouses
praunus: praunuses
priacanthus: priacanthuses
priapus: priapuses
primus: primuses
prionotus: prionotuses
pristis: pristises
pritzelago: pritzelagoes
prociphilus: prociphiluses
prometheus: prometheuses
prosopis: prosopises
prosopium: prosopiums
proteus: proteuses
protium: protiums
prunus: prunuses
psaltriparus: psaltriparuses
psephurus: psephuruses
pseudacris: pseudacrises
pseudechis: pseudechises
pseudococcus: pseudococcuses
pseudocolus: pseudocoluses
pseudotaxus: pseudotaxuses
psidium: psidiums
psilotum: psilotums
psithyrus: psithyruses
psittacus: psittacuses
psophocarpus: psophocarpuses
psychopsis: psychopsises
pteretis: pteretises
pteridium: pteridiums
pteris: pterises
pterocarpus: pterocarpuses
pterodactylus: pterodactyluses
pterois: pteroises
pteropus: pteropuses
pterospermum: pterospermums
pterostylis: pterostylises
ptilocercus: ptilocercuses
ptilocrinus: ptilocrinuses
ptilonorhynchus: ptilonorhynchuses
ptloris: ptloris
puffinus: puffinuses
pullman: pullmans
purus: puruses
pycnanthemum: pycnanthemums
pygopus: pygopuses
pygoscelis: pygoscelises
pylodictus: pylodictuses
pyralis: pyralises
pyrethrum: pyrethrums
pyrocephalus: pyrocephaluses
pyrophorus: pyrophoruses
pyrrhus: pyrrhuses
pyrus: pyruses
pythius: pythiuses
quercus: quercuses
quiscalus: quiscaluses
quito: quitoes
qum: qums
rabelais: rabelaises
ramman: rammans
ranunculus: ranunculuses
raphanus: raphanuses
raphicerus: raphiceruses
raphus: raphuses
rattus: rattuses
recife: recifes
regina: reginae
reglaecus: reglaecuses
regulus: reguluses
remus: remuses
reno: renoes
retrophyllum: retrophyllums
rhadamnathus: rhadamnathuses
rhagoletis: rhagoletises
rhamnus: rhamnuses
rhapis: rhapises
rheum: rheums
rhibhus: rhibhuses
rhinonicteris: rhinonicterises
rhipsalis: rhipsalises
rhizobium: rhizobiums
rhus: rhuses
rhyncostylis: rhyncostylises
ribhus: ribhuses
ricinus: ricinuses
rio: rioes
ro: roes
roccus: roccuses
roman: romans
romulus: romuluses
ron: ra
roneo: roneoes
rosmarinus: rosmarinuses
rubus: rubuses
ruscus: ruscuses
rutilus: rutiluses
rypticus: rypticuses
s: ses
saccharum: saccharums
sacramento: sacramentoes
sagittarius: sagittariuses
sakartvelo: sakartveloes
salerno: salernoes
salmo: salmoes
salvelinus: salvelinuses
sambucus: sambucuses
samolus: samoluses
sangay: sangays
sango: sangoes
santalum: santalums
santiago: santiagoes
sapindus: sapinduses
sappho: sapphoes
sapporo: sapporoes
sarajevo: sarajevoes
sarcobatus: sarcobatuses
sarcocephalus: sarcocephaluses
sarcochilus: sarcochiluses
sarcocystis: sarcocystises
sarcophilus: sarcophiluses
sarcorhamphus: sarcorhamphuses
sassenach: sassenachs
saturday: saturdays
sauromalus: sauromaluses
saurosuchus: saurosuchuses
saururus: saururuses
sayornis: sayornises
scaphiopus: scaphiopuses
scaphosepalum: scaphosepalums
scardinius: scardiniuses
sceloporus: sceloporuses
schinus: schinuses
schizachyrium: schizachyriums
schweiz: schweizzes
scincus: scincuses
scindapsus: scindapsuses
scipio: scipioes
scirpus: scirpuses
sciurus: sciuruses
scleranthus: scleranthuses
scolymus: scolymuses
scolytus: scolytuses
scomberomorus: scomberomoruses
scophthalmus: scophthalmuses
scorpius: scorpiuses
seismosaurus: seismosauruses
seiurus: seiuruses
selenicereus: selenicereuses
selenipedium: selenipediums
seleucus: seleucuses
senecio: senecioes
septobasidium: septobasidiums
sericocarpus: sericocarpuses
serinus: serinuses
seriphidium: seriphidiums
seriphus: seriphuses
serranus: serranuses
serrasalmus: serrasalmuses
sesamum: sesamums
sesotho: sesothoes
seychellois: seychelloises
shavous: shavouses
shiraz: shirazzes
sialis: sialises
sideritis: sideritises
silenus: silenuses
sillago: sillagoes
silphium: silphiums
silurus: siluruses
silvanus: silvanuses
silybum: silybums
simulium: simuliums
sinanthropus: sinanthropuses
sinapis: sinapises
sinornis: sinornises
sirius: siriuses
sistrurus: sistruruses
sisyphus: sisyphuses
sisyrinchium: sisyrinchiums
sitophylus: sitophyluses
sium: siums
sivapithecus: sivapithecuses
slezsko: slezskoes
smyrnium: smyrniums
sokoro: sokoroes
solanopteris: solanopterises
solanum: solanums
solenopsis: solenopsises
solidago: solidagoes
sonchus: sonchuses
sorbus: sorbuses
sothis: sothises
soweto: sowetoes
sparaxis: sparaxisses
sparganium: sparganiums
spartium: spartiums
spermophilus: spermophiluses
sphaerocarpus: sphaerocarpuses
sphecius: spheciuses
spheniscus: spheniscuses
sphyrapicus: sphyrapicuses
spinus: spinuses
sporobolus: sporoboluses
squalus: squaluses
stalino: stalinoes
statehouse: statehouses
stayman: staymans
steatornis: steatornises
steganopus: steganopuses
stenocarpus: stenocarpuses
stenopelmatus: stenopelmatuses
stenotaphrum: stenotaphrums
stenotomus: stenotomuses
stenotus: stenotuses
stercorarius: stercorariuses
sternotherus: sternotheruses
stheno: sthenoes
sticherus: sticheruses
stizolobium: stizolobiums
strombus: strombuses
struthio: struthioes
sturnus: sturnuses
stylophorum: stylophorums
suillus: suilluses
sundacarpus: sundacarpuses
sunday: sundays
sydney: sydneys
sylvanus: sylvanuses
sylvilagus: sylvilaguses
symphalangus: symphalanguses
symphytum: symphytums
symplocarpus: symplocarpuses
symplocus: symplocuses
synchytrium: synchytriums
synercus: synercuses
syngnathus: syngnathuses
syngonium: syngoniums
syzygium: syzygiums
tabasco: tabascoes
tachyglossus: tachyglossuses
tachypleus: tachypleuses
tagus: taguses
takilman: takilmans
talinum: talinums
tamarindus: tamarinduses
tamiasciurus: tamiasciuruses
tamus: tamuses
tanacetum: tanacetums
tantalus: tantaluses
tapirus: tapiruses
taraxacum: taraxacums
tarsius: tarsiuses
tartarus: tartaruses
tashmitum: tashmitums
taurotragus: taurotraguses
taurus: tauruses
tautogolabrus: tautogolabruses
taxodium: taxodiums
taxus: taxuses
tay: tays
tellus: telluses
tetraclinis: tetraclinises
tetragonurus: tetragonuruses
tetraneuris: tetraneurises
tetrao: tetraoes
tetrapturus: tetrapturuses
teucrium: teucriums
thalictrum: thalictrums
thammuz: thammuzzes
thamnophilus: thamnophiluses
thamnophis: thamnophises
thelypteris: thelypterises
themis: themises
thermopsis: thermopsises
theseus: theseuses
thetis: thetises
tho: thoes
threskiornis: threskiornises
thryothorus: thryothoruses
thujopsis: thujopsises
thunnus: thunnuses
thursday: thursdays
thylacinus: thylacinuses
thymus: thymuses
thysanocarpus: thysanocarpuses
ticino: ticinoes
tiflis: tiflises
tigris: tigrises
titanosaurus: titanosauruses
tobago: tobagoes
todus: toduses
togo: togoes
tokay: tokays
tokio: tokioes
tokyo: tokyoes
tolstoy: tolstoys
torino: torinoes
toronto: torontoes
trachelospermum: trachelospermums
trachinotus: trachinotuses
trachipterus: trachipteruses
trachurus: trachuruses
tragelaphus: tragelaphuses
tragulus: traguluses
tribolium: triboliums
tribulus: tribuluses
trichechus: trichechuses
trichoglossus: trichoglossuses
trichosurus: trichosuruses
trifolium: trifoliums
triostium: triostiums
tripleurospermum: tripleurospermums
triticum: triticums
triturus: trituruses
trogium: trogiums
trollius: trolliuses
tropaeolum: tropaeolums
troy: troys
truman: trumans
tuesday: tuesdays
tungus: tunguses
tunguz: tunguzzes
tunis: tunises
tupinambis: tupinambises
tupungatito: tupungatitoes
tupungato: tupungatoes
turcoman: turcomans
turdus: turduses
turkey: turkeys
turkoman: turkomans
turritis: turritises
tussilago: tussilagoes
tutelo: tuteloes
tylenchus: tylenchuses
tympanuchus: tympanuchuses
typhoeus: typhoeuses
typhon: typha
tyto: tytoes
uintatherium: uintatheriums
ulmus: ulmuses
unio: unioes
uranus: uranuses
urocystis: urocystises
urophycis: urophycises
uropsilus: uropsiluses
urosaurus: urosauruses
ursus: ursuses
uruguay: uruguays
ustilago: ustilagoes
utrillo: utrilloes
vaccinium: vacciniums
vaduz: vaduzzes
valdez: valdezzes
valium: valiums
valparaiso: valparaisoes
vanellus: vanelluses
varanus: varanuses
veneto: veneti
venus: venuses
veracruz: veracruzzes
veratrum: veratrums
verbascum: verbascums
verrazano: verrazanoes
verrazzano: verrazzanoes
vesalius: vesaliuses
vespertilio: vespertilioes
vesuvius: vesuviuses
viburnum: viburnums
vilnius: vilniuses
vilno: vilnoes
vincetoxicum: vincetoxicums
viscum: viscums
vitis: vitises
who: whoes
wahvey: wahveys
wednesday: wednesdays
wesley: wesleys
whitmonday: whitmondays
whitney: whitneys
whitsunday: whitsundays
winnebago: winnebagoes
x: xes
xanthium: xanthiums
xenicus: xenicuses
xenopus: xenopuses
xenorhyncus: xenorhyncuses
xenosaurus: xenosauruses
xerophyllum: xerophyllums
xylomelum: xylomelums
xyphophorus: xyphophoruses
xyris: xyrises
yafo: yafoes
yay: yays
yeddo: yeddoes
yedo: yedoes
yenisey: yeniseys
yezo: yezoes
yucateco: yucatecoes
yuman: yumans
z: zes
zaglossus: zaglossuses
zalophus: zalophuses
zanthoxylum: zanthoxylums
zapus: zapuses
zeno: zenoes
zeus: zeuses
zigadenus: zigadenuses
zinjanthropus: zinjanthropuses
ziziphus: ziziphuses
zygocactus: zygocactuses
zygophyllum: zygophyllums
abacus: abacuses
abatis: abatises
abattis: abattises
abbey: abbeys
abecedarius: abecedariuses
abortus: abortuses
acanthus: acanthuses
acaridiasis: acaridiasises
acathexis: acathexises
acetabulum: acetabulums
acromphalus: acromphaluses
acropolis: acropolises
actinium: actiniums
adenitis: adenitises
adenovirus: adenoviruses
aegis: aegises
aepyornis: aepyornises
aeschynanthus: aeschynanthuses
afflatus: afflatuses
affray: affrays
afropavo: afropavoes
agapanthus: agapanthuses
agape: agapae
agendum: agendums
ageratum: ageratum
ailanthus: ailanthuses
airbus: airbuses
aircraftsman: aircraftsmans
aircrewman: aircrewmans
airplay: airplays
airway: airways
alarum: alarums
albatross: albatross
albedo: albedoes
album: albums
alehouse: alehouses
alga: algae
alkali: alkalies
allantois: allantoises
alley: alleys
alleyway: alleyways
alligatorfish: alligatorfish
allis: allises
allosaurus: allosauruses
alloy: alloys
alluvium: alluviums
almshouse: almshouses
alnico: alnicoes
alum: alums
aluminium: aluminiums
aluminum: aluminums
alumna: alumnae
alumroot: alumroots
alundum: alundums
alveolitis: alveolitises
amaryllis: amaryllises
amberfish: amberfish
ambergris: ambergrises
americium: americiums
ammobium: ammobiums
ammonium: ammoniums
amorphophallus: amorphophalluses
amphibrach: amphibrachs
amphioxus: amphioxuses
amphora: amphorae
ampulla: ampullae
amylum: amylums
anastalsis: anastalsises
anchorperson: anchorpeople
anestrum: anestrums
anestrus: anestruses
angelfish: angelfish
angiitis: angiitises
angiopteris: angiopterises
anglerfish: anglerfish
angrecum: angrecums
animus: animuses
ankylosaurus: ankylosauruses
annulus: annuluses
anoestrum: anoestrums
anoestrus: anoestruses
antheridium: antheridiums
anthrax: anthraces
anthurium: anthuriums
antihero: antiheroes
antiserum: antiserums
antrum: antrums
anulus: anuluses
anus: anuses
aoritis: aoritises
apatosaurus: apatosauruses
aphelion: aphelia
apoapsis: apoapsises
apomixis: apomixises
apparatus: apparatuses
appendicitis: appendicitises
appendix: appendices
appro: approes
aquarium: aquariums
arboretum: arboretums
arbutus: arbutuses
arcanum: arcanums
archaeornis: archaeornises
archerfish: archerfish
archipallium: archipalliums
architeuthis: architeuthises
archway: archways
arcus: arcuses
areaway: areaways
armamentarium: armamentariums
arquebus: arquebuses
array: arrays
arrowroot: arrowroots
arteriectasis: arteriectasises
arteritis: arteritises
arthritis: arthritides
articulatio: articulatioes
arum: arums
ascoma: ascomata
ashtray: ashtrays
asparagus: asparaguses
assay: assays
asylum: asylums
ataraxis: ataraxisses
athenaeum: athenaeums
atheneum: atheneums
attorney: attorneys
auditorium: auditoriums
auspex: auspices
austral: australes
autobus: autobuses
avoirdupois: avoirdupoises
axis: axises
ay: ayes
backstay: backstays
baggageman: baggagemans
bailey: baileys
bakshis: bakshises
balanitis: balanitises
balanoposthitis: balanoposthitises
balibago: balibagoes
balloonfish: balloonfish
baloney: baloneys
balsamroot: balsamroots
bandeau: bandeaux
bandicoot: bandicoots
barbasco: barbascoes
barium: bariums
barklouse: barklouses
barley: barleys
barosaurus: barosauruses
barrelfish: barrelfish
barrelhouse: barrelhouses
basileus: basileuses
bastinado: bastinadoes
batfish: batfish
bathhouse: bathhouses
bawdyhouse: bawdyhouses
bay: bays
bdellium: bdelliums
bedesman: bedesmans
beef: beeves
beefalo: beefaloes
beetroot: beetroots
begum: begums
behalf: behalves
belay: belays
bellboy: bellboys
beltway: beltways
berkelium: berkeliums
beryllium: berylliums
bey: beys
biceps: biceps
biennium: bienniums
bijou: bijoux
billfish: billfish
billyo: billyoes
bimillennium: bimillenniums
bioassay: bioassays
birdhouse: birdhouses
birthday: birthdays
birthroot: birthroots
bitterroot: bitterroots
biz: bizzes
blackfish: blackfish
blanquillo: blanquilloes
blarney: blarneys
blepharitis: blepharitides
blockhouse: blockhouses
bloodroot: bloodroots
blouse: blouses
blowfish: blowfish
bluejay: bluejays
boardinghouse: boardinghouses
boarfish: boarfish
boathouse: boathouses
boloney: boloneys
bolus: boluses
bonefish: bonefish
bonus: bonuses
booklouse: booklouses
boot: boots
booth: booths
botulinum: botulinums
botulinus: botulinuses
bourgeois: bourgeois
boxfish: boxfish
boy: boys
brainchild: brainchildren
branchia: branchiae
bravado: bravadoes
bray: brays
breadroot: breadroots
breakaway: breakaways
breezeway: breezeways
bregma: bregmata
briarroot: briarroots
bronchiolitis: bronchiolitises
bronchitis: bronchitises
brontosaurus: brontosauruses
bryanthus: bryanthuses
bubblegum: bubblegums
buffalofish: buffalofish
bufo: bufoes
bullyboy: bullyboys
bum: bums
bunkhouse: bunkhouses
bunkum: bunkums
buoy: buoys
burnous: burnouses
burnouse: burnouses
burrfish: burrfish
bursa: bursae
bursitis: bursitises
bus: buses
busboy: busboys
businessperson: businesspeople
butterfish: butterfish
butterflyfish: butterflyfish
buy: buys
by: byes
byplay: byplays
byssus: byssuses
byway: byways
cabassous: cabassouses
cadmium: cadmiums
caesium: caesiums
cahoot: cahoots
caiman: caimans
caimitillo: caimitilloes
caimito: caimitoes
caladium: caladiums
calceus: calceuses
calcium: calciums
calf: calves
calico: calicoes
caliculus: caliculuses
californium: californiums
calliopsis: calliopsises
callus: calluses
cambium: cambiums
campus: campuses
cannabis: cannabises
capsicum: capsicums
capuccino: capuccinoes
caracolito: caracolitoes
caranday: carandays
caraway: caraways
carbonado: carbonadoes
carborundum: carborundums
carboy: carboys
cardamum: cardamums
cardhouse: cardhouses
cardinalfish: cardinalfish
carditis: carditises
cargo: cargoes
carney: carneys
carouse: carouses
carriageway: carriageways
carrizo: carrizoes
castaway: castaways
catfish: catfish
cathouse: cathouses
cattalo: cattaloes
caucus: caucuses
causeway: causeways
cautious: cautiouses
cavum: cavums
cay: cays
cayman: caymans
ceibo: ceiboes
cellulitis: cellulitises
celoma: celomata
census: censuses
centrum: centrums
ceratodus: ceratoduses
ceratosaurus: ceratosauruses
cerebellum: cerebellums
cerebrum: cerebrums
ceriman: cerimans
cerium: ceriums
cervicitis: cervicitises
cervix: cervices
cesium: cesiums
chaenactis: chaenactises
chaeta: chaetae
challis: challises
chambray: chambrays
chamois: chamois
chantey: chanteys
chapterhouse: chapterhouses
charisma: charismata
chassis: chassis
chateau: chateaux
cheilitis: cheilitises
cheiloschisis: cheiloschisises
chelicera: chelicerae
cheroot: cheroots
chetrum: chetrums
chiasmus: chiasmuses
child: children
chili: chilies
chilli: chillies
chimney: chimneys
chinchillon: chinchilla
chlamydia: chlamydiae
choirboy: choirboys
chokey: chokeys
cholangitis: cholangitises
cholecystitis: cholecystitides
chon: cha
chophouse: chophouses
choragus: choraguses
chorditis: chorditises
chorioallantois: chorioallantoises
chorioretinitis: chorioretinitises
chorus: choruses
chromium: chromiums
chrysalis: chrysalises
chrysanthemum: chrysanthemums
chum: chums
chutney: chutneys
cicatrix: cicatrices
cicerone: ciceroni
cigarfish: cigarfish
cirio: cirioes
cirrhus: cirrhuses
cisco: ciscoes
cisterna: cisternae
citrus: citruses
claro: claroes
clay: clays
clearinghouse: clearinghouses
clearway: clearways
cleistothecium: cleistotheciums
clematis: clematises
clevis: clevises
clianthus: clianthuses
clingfish: clingfish
clitoris: clitorises
cloaca: cloacae
clonus: clonuses
clostridium: clostridiums
cloverleaf: cloverleafs
cloveroot: cloveroots
clubhouse: clubhouses
clypeus: clypeuses
coagulum: coagulums
coccyx: coccyges
cochlea: cochleae
cocksfoot: cocksfoots
codex: codices
codfish: codfish
coelenteron: coelentera
coffeehouse: coffeehouses
cognoscente: cognoscenti
coitus: coituses
coleus: coleuses
colicroot: colicroots
coliseum: coliseums
colitis: colitises
colloquium: colloquiums
collyrium: collyriums
colobus: colobuses
coloradillo: coloradilloes
colostrum: colostrums
colpitis: colpitises
colpocystitis: colpocystitises
coltsfoot: coltsfoots
columbium: columbiums
columbo: columboes
combretum: combretums
comfrey: comfreys
companionway: companionways
compendium: compendiums
compsognathus: compsognathuses
conceptus: conceptuses
conch: conchs
conchfish: conchfish
condominium: condominiums
coney: coneys
congressperson: congresspeople
conjunctivitis: conjunctivitises
consensus: consensuses
conspectus: conspectuses
contadino: contadini
contretemps: contretemps
conundrum: conundrums
convictfish: convictfish
convolvulus: convolvuluses
convoy: convoys
cookhouse: cookhouses
coot: coots
copay: copays
coralroot: coralroots
corchorus: corchoruses
corduroy: corduroys
coreopsis: coreopsises
corium: coriums
cornetfish: cornetfish
coronach: coronachs
corps: corps
corpus: corpora
cortex: cortices
corundum: corundums
corythosaurus: corythosauruses
cosey: coseys
costa: costae
costiasis: costiasises
costochondritis: costochondritises
costusroot: costusroots
countinghouse: countinghouses
courthouse: courthouses
couscous: couscouses
covey: coveys
cowboy: cowboys
cowfish: cowfish
cowhouse: cowhouses
coxa: coxae
coxsackievirus: coxsackieviruses
cozey: cozeys
crampfish: crampfish
cranium: craniums
crawfish: crawfish
crayfish: crayfish
crematorium: crematoriums
crinkleroot: crinkleroots
criterion: criteria
crocus: crocuses
cromlech: cromlechs
crossway: crossways
crus: cruses
cubitus: cubituses
cullis: cullises
cumfrey: cumfreys
cuneus: cuneuses
cunnilinctus: cunnilinctuses
cunnilingus: cunnilinguses
curia: curiae
curium: curiums
curtsey: curtseys
cuscus: cuscuses
customhouse: customhouses
cutaway: cutaways
cuticula: cuticulae
cutis: cutises
cutlassfish: cutlassfish
cuttlefish: cuttlefish
cymatium: cymatiums
cymbidium: cymbidiums
cynancum: cynancums
cystitis: cystitides
cytomegalovirus: cytomegaloviruses
dado: dadoes
dago: dagoes
dais: daises
dalo: dali
damselfish: damselfish
darkey: darkeys
day: days
dayboy: dayboys
dealfish: dealfish
debris: debris
decay: decays
decennium: decenniums
decorum: decorums
decoy: decoys
deejay: deejays
deinocheirus: deinocheiruses
deinonychus: deinonychuses
deixis: deixises
delay: delays
delf: delfs
delirium: deliriums
delphinium: delphiniums
dendrobium: dendrobiums
denotatum: denotatums
dermatitis: dermatitises
dermis: dermises
derris: derrises
designatum: designatums
desperado: desperadoes
detritus: detritus
deuterium: deuteriums
devilfish: devilfish
diabetes: diabetes
diazonium: diazoniums
dickey: dickeys
dictostylium: dictostyliums
die: dice
diestrum: diestrums
diestrus: diestruses
differentia: differentiae
digitalis: digitalises
dildo: dildoes
dingo: dingoes
dingus: dinguses
diplodocus: diplodocuses
dipteron: diptera
diptych: diptychs
disarray: disarrays
discus: discuses
disequilibrium: disequilibriums
dismay: dismays
display: displays
distich: distichs
diverticulitis: diverticulitises
dj: djes
doctorfish: doctorfish
doghouse: doghouses
dohickey: dohickeys
doliolum: doliolums
dollarfish: dollarfish
dollhouse: dollhouses
dolman: dolmans
dolphinfish: dolphinfish
dominatrix: dominatrices
domino: dominoes
dominus: dominuses
donkey: donkeys
doofus: doofuses
doohickey: doohickeys
doorway: doorways
dorsum: dorsums
dosshouse: dosshouses
douse: douses
doyley: doyleys
dracontium: dracontiums
dragoman: dragomans
dray: drays
driftfish: driftfish
driveway: driveways
drum: drums
drumfish: drumfish
dry: drys
drypis: drypises
ductulus: ductuluses
dumdum: dumdums
durum: durums
dybbuk: dybbukim
dysprosium: dysprosiums
eardrum: eardrums
echinocactus: echinocactuses
echo: echoes
echovirus: echoviruses
eclipsis: eclipsises
ectozoon: ectozoa
edaphosaurus: edaphosauruses
eddo: eddoes
edmontosaurus: edmontosauruses
egis: egises
einsteinium: einsteiniums
elasmobranch: elasmobranchs
eldorado: eldoradoes
electrum: electrums
embargo: embargoes
embolus: emboluses
emerita: emeritae
employ: employs
emporium: emporiums
encephalitis: encephalitides
encomium: encomiums
endocarditis: endocarditises
endocardium: endocardiums
endometritis: endometritises
endometrium: endometriums
entellus: entelluses
enteritis: enteritises
enterovirus: enteroviruses
entozoon: entozoa
entranceway: entranceways
entryway: entryways
envoy: envoys
eohippus: eohippuses
epacris: epacrises
ephemeris: ephemerises
epidermis: epidermises
epididymis: epididymises
epiglottis: epiglottises
epiphyllum: epiphyllums
epiplexis: epiplexises
epithelium: epitheliums
epizoon: epizoa
epoch: epochs
eptatretus: eptatretuses
equilibrium: equilibriums
erbium: erbiums
eringo: eringoes
eriogonum: eriogonums
eryngo: eryngoes
essay: essays
estrus: estruses
eucalyptus: eucalyptuses
eunuch: eunuchs
euphonium: euphoniums
europium: europiums
eusporangium: eusporangiums
excursus: excursuses
executrix: executrices
expressway: expressways
exwife: exwifes
factotum: factotums
fairway: fairways
famulus: famuluses
farmhouse: farmhouses
farrago: farragoes
fasiculus: fasiculuses
fatso: fatsoes
fay: fays
fecula: feculae
femoris: femorises
fermium: fermiums
ferrocerium: ferroceriums
fetus: fetuses
feverroot: feverroots
fez: fezzes
fiasco: fiascoes
fibrositis: fibrositises
fibula: fibulae
fife: fifes
filago: filagoes
filaria: filariae
filefish: filefish
fingerroot: fingerroots
finis: finises
fireclay: fireclays
firehouse: firehouses
fish: fish
fistulous: fistulouses
flagfish: flagfish
flagroot: flagroots
flamefish: flamefish
flatfish: flatfish
flatfoot: flatfoots
flatus: flatuses
flophouse: flophouses
flunkey: flunkeys
flyby: flybys
flyway: flyways
focus: focuses
foetus: foetuses
fogey: fogeys
foldaway: foldaways
folium: foliums
folkway: folkways
foray: forays
forceps: forceps
foreperson: forepeople
foreplay: foreplays
forestay: forestays
forum: forums
francium: franciums
fray: frays
freeway: freeways
fresco: frescoes
frijol: frijoles
frijolillo: frijolilloes
frijolito: frijolitoes
friz: frizzes
frogfish: frogfish
frosh: frosh
frustum: frustums
fry: fry
fucus: fucuses
fulcrum: fulcrums
fumeroot: fumeroots
fuzz: fuzz
gadolinium: gadoliniums
galbanum: galbanums
galley: galleys
gallium: galliums
gallous: gallouses
gallows: gallows
galoot: galoots
ganglion: ganglia
gangway: gangways
garfish: garfish
garganey: garganeys
gastritis: gastritides
gastroenteritis: gastroenteritides
gastrolobium: gastrolobiums
gatehouse: gatehouses
gateway: gateways
gay: gays
gemma: gemmae
genius: geniuses
genus: genera
geranium: geraniums
germanium: germaniums
getaway: getaways
ghostfish: ghostfish
gigahertz: gigahertz
gingerroot: gingerroots
gingiva: gingivae
gingivitis: gingivitises
gingko: gingkoes
ginglymus: ginglymuses
ginkgo: ginkgoes
giveaway: giveaways
glans: glandes
glasshouse: glasshouses
gleba: glebae
glissando: glissandi
globefish: globefish
globigerina: globigerinae
glomerulonephritis: glomerulonephritides
glossitis: glossitises
glottis: glottises
glucinium: gluciniums
gnetum: gnetums
goatfish: goatfish
godchild: godchildren
goldfish: goldfish
goodby: goodbys
gooney: gooneys
goose: geese
goosefish: goosefish
goosefoot: goosefoots
goy: goys
graffito: graffiti
grampus: grampuses
granadillo: granadilloes
grandchild: grandchildren
gray: grays
greenhouse: greenhouses
greenway: greenways
grey: greys
grissino: grissinoes
gross: gross
grotto: grottoes
groundfish: groundfish
grouse: grouse
guacharo: guacharoes
guardhouse: guardhouses
guesthouse: guesthouses
guitarfish: guitarfish
gulley: gulleys
gum: gums
gunplay: gunplays
gurney: gurneys
gusto: gustoes
gynoecium: gynoeciums
gypsum: gypsums
gyrus: gyruses
hackney: hackneys
hadj: hadjes
hadrosaurus: hadrosauruses
hafnium: hafniums
hagfish: hagfish
haggis: haggises
hahnium: hahniums
haj: hajes
hajj: hajjes
half: halves
halfpenny: halfpence
hallway: hallways
hankey: hankeys
hao: haoes
harmonium: harmoniums
harquebus: harquebuses
harvestfish: harvestfish
hatchway: hatchways
hautbois: hautboises
hautboy: hautboys
hay: hays
headfish: headfish
headscarf: headscarves
headway: headways
hearsay: hearsays
heartleaf: heartleafs
helianthemum: helianthemums
helianthus: helianthuses
heliopsis: heliopsises
helium: heliums
henhouse: henhouses
hepadnavirus: hepadnaviruses
hepatitis: hepatitides
hero: heroes
herrerasaurus: herrerasauruses
heyday: heydays
hiatus: hiatuses
hibiscus: hibiscuses
hickey: hickeys
hideaway: hideaways
hierarch: hierarchs
highboy: highboys
highway: highways
hippeastrum: hippeastrums
hippopotamus: hippopotamuses
his: hisses
hobbledehoy: hobbledehoys
hockey: hockeys
hogfish: hogfish
hokum: hokums
holiday: holidays
hollo: holloes
holmium: holmiums
homeboy: homeboys
homeless: homeless
homey: homeys
honey: honeys
honorarium: honorariums
hoodlum: hoodlums
hooey: hooeys
hookey: hookeys
hooray: hoorays
hoot: hoots
horsefish: horsefish
horseflesh: horseflesh
horseplay: horseplays
hotfoot: hotfoots
hothouse: hothouses
house: houses
houseboy: houseboys
hoy: hoys
hubris: hubrises
hum: hums
human: humans
humdrum: humdrums
hummus: hummuses
humus: humuses
hurray: hurrays
hymenium: hymeniums
hypha: hyphae
hypobasidium: hypobasidiums
hypodermis: hypodermises
hypostasis: hypostasises
hypozeuxis: hypozeuxises
iambus: iambuses
ibex: ibex
ibis: ibis
icaco: icacoes
icehouse: icehouses
icetray: icetrays
ichthyosaurus: ichthyosauruses
ictus: ictuses
ignoramus: ignoramuses
ileitis: ileitides
imago: imagoes
imaum: imaums
impatiens: impatiens
impetus: impetuses
incienso: inciensoes
incubus: incubuses
incus: incuses
indecorum: indecorums
indium: indiums
indris: indrises
inlay: inlays
insigne: insignia
interplay: interplays
interregnum: interregnums
intravenous: intravenouses
iridium: iridiums
iridocyclitis: iridocyclitises
iridokeratitis: iridokeratitises
iris: irises
islay: islays
isthmus: isthmuses
jaboncillo: jaboncilloes
jackboot: jackboots
jailhouse: jailhouses
jambeau: jambeaux
jawfish: jawfish
jay: jays
jejunitis: jejunitises
jejunoileitis: jejunoileitises
jellyfish: jellyfish
jewfish: jewfish
jimhickey: jimhickeys
jingo: jingoes
jitney: jitneys
jobless: jobless
jockey: jockeys
jorum: jorums
journey: journeys
joy: joys
keratitis: keratitides
keratoiritis: keratoiritises
keratoscleritis: keratoscleritises
kernicterus: kernicteruses
kettledrum: kettledrums
key: keys
khoum: khoums
kibbutz: kibbutzim
kidney: kidneys
kiley: kileys
killjoy: killjoys
kilohertz: kilohertz
kingfish: kingfish
kinsperson: kinspeople
kohlrabi: kohlrabies
krona: kronur
krone: kroner
kumis: kumisses
kurchatovium: kurchatoviums
labdanum: labdanums
labyrinthitis: labyrinthitises
lackey: lackeys
lacuna: lacunae
ladanum: ladanums
ladyfish: ladyfish
lamellibranch: lamellibranchs
lamina: laminae
laminitis: laminitises
lamprey: lampreys
lancetfish: lancetfish
langley: langleys
lanternfish: lanternfish
lanthanum: lanthanums
larcenous: larcenouses
larva: larvae
laryngitis: laryngitides
larynx: larynges
latchkey: latchkeys
latex: latices
laudanum: laudanums
lavabo: lavaboes
lawrencium: lawrenciums
lay: lays
layaway: layaways
layperson: laypeople
leatherfish: leatherfish
lebensraum: lebensraums
lecanopteris: lecanopterises
ledgeman: ledgemans
leeway: leeways
lepidopteron: lepidoptera
leptocephalus: leptocephaluses
lepton: lepta
leptosporangium: leptosporangiums
less: less
levis: levises
lexis: lexises
ley: leys
liebfraumilch: liebfraumilchs
lied: lieder
lifebuoy: lifebuoys
lighthouse: lighthouses
lignum: lignums
limbus: limbuses
limey: limeys
lingo: lingoes
linkboy: linkboys
linoleum: linoleums
lionfish: lionfish
lira: lire
lithium: lithiums
litmus: litmuses
lizardfish: lizardfish
loaf: loaves
lobscouse: lobscouses
loch: lochs
locum: locums
logomach: logomachs
loligo: loligoes
longroot: longroots
looney: looneys
loosestrife: loosestrifes
loot: loots
lorica: loricae
loris: lorises
lovechild: lovechildren
lowboy: lowboys
lowerclassman: lowerclassmans
lowlife: lowlifes
lumpfish: lumpfish
lustrum: lustrums
lutecium: luteciums
lutetium: lutetiums
lyceum: lyceums
lychnis: lychnises
lynx: lynx
maconnais: maconnaises
macrotus: macrotuses
madame: mesdames
madhouse: madhouses
mafioso: mafiosi
magnesium: magnesiums
magnificio: magnificioes
magnum: magnums
maguey: magueys
mainstay: mainstays
makomako: makomakoes
malarkey: malarkeys
maleo: maleoes
malinois: malinoises
malleus: malleuses
malmsey: malmseys
mamey: mameys
mamilla: mamillae
mammilla: mammillae
mamo: mamoes
mamoncillo: mamoncilloes
mandamus: mandamuses
mangabey: mangabeys
mango: mangoes
manroot: manroots
manservant: menservants
mantis: mantises
manubrium: manubriums
manus: manuses
marasmus: marasmuses
margay: margays
markka: markkaa
marquis: marquises
marri: marries
mastitis: mastitides
mastoiditis: mastoiditides
matman: matmans
matriarch: matriarchs
matrix: matrices
matzo: matzoth
mausoleum: mausoleums
mavis: mavises
maxilla: maxillae
maximum: maximums
mayfish: mayfish
meatloaf: meatloaves
meatus: meatuses
meconium: meconiums
medley: medleys
meerschaum: meerschaums
meetinghouse: meetinghouses
megahertz: megahertz
megalopolis: megalopolises
megalosaurus: megalosauruses
melilotus: melilotuses
memorandum: memorandums
mendelevium: mendeleviums
meningitis: meningitides
meninx: meninges
mentum: mentums
mesohippus: mesohippuses
metis: metisses
metritis: metritises
metropolis: metropolises
mezereum: mezereums
microcephalus: microcephaluses
midday: middays
military: military
millennium: millenniums
minibus: minibuses
minimum: minimums
miniseries: miniseries
minium: miniums
minus: minuses
minutia: minutiae
miro: miri
misplay: misplays
missis: missises
missus: missuses
mitochondrion: mitochondria
modicum: modicums
molybdenum: molybdenums
monarch: monarchs
money: moneys
mongo: mongoes
monkey: monkeys
monkfish: monkfish
monseigneur: messeigneurs
moonfish: moonfish
moonray: moonrays
moot: moots
moratorium: moratoriums
moray: morays
mosquito: mosquitoes
mosquitofish: mosquitofish
motley: motleys
motorbus: motorbuses
motorway: motorways
motto: mottoes
mucus: mucuses
mulloway: mulloways
mum: mums
munj: munjes
musculus: musculuses
museum: museums
muskox: muskoxen
muttonfish: muttonfish
my: mys
myelitis: myelitides
myocarditis: myocarditises
myocardium: myocardiums
myxovirus: myxoviruses
nameko: namekoes
nardo: nardoes
natatorium: natatoriums
nautilus: nautiluses
nay: nays
nebula: nebulae
necropolis: necropolises
needlefish: needlefish
negus: neguses
neocortex: neocortices
neodymium: neodymiums
neopallium: neopalliums
nephritis: nephritides
nephrolithiasis: nephrolithiasises
nephthytis: nephthytises
neptunium: neptuniums
nerveroot: nerveroots
nervus: nervuses
neuritis: neuritides
newsboy: newsboys
newsperson: newspeople
nexus: nexuses
ngultrum: ngultrums
nidus: niduses
nightlife: nightlifes
niobium: niobiums
nisus: nisuses
nobelium: nobeliums
nonplus: nonpluses
noonday: noondays
nosegay: nosegays
nostrum: nostrums
notornis: notornises
noumenon: noumena
nous: nouses
nucellus: nucelluses
nudibranch: nudibranchs
numbfish: numbfish
nuthouse: nuthouses
oakum: oakums
oarfish: oarfish
octopus: octopuses
odium: odiums
odontoglossum: odontoglossums
offshoot: offshoots
oilfish: oilfish
okay: okays
okey: okeys
olibanum: olibanums
oligarch: oligarchs
omentum: omentums
omnibus: omnibuses
oncidium: oncidiums
onus: onuses
operculum: operculums
ophthalmitis: ophthalmitises
opium: opiums
opossum: opossums
opprobrium: opprobriums
opus: opera
orchis: orchises
orchitis: orchitises
oreo: oreoes
origanum: origanums
orphrey: orphreys
orris: orrises
orrisroot: orrisroots
orthomyxovirus: orthomyxoviruses
osmium: osmiums
osprey: ospreys
ossiculum: ossiculums
osteitis: osteitides
osteoarthritis: osteoarthritides
osteomyelitis: osteomyelitides
otitis: otitides
ottoman: ottomans
outgo: outgoes
outhouse: outhouses
outlay: outlays
overlay: overlays
overplus: overpluses
overshoot: overshoots
ox: oxen
oxalis: oxalises
oxymoron: oxymora
oysterfish: oysterfish
pabulum: pabulums
pachycephalosaurus: pachycephalosauruses
packinghouse: packinghouses
paddlefish: paddlefish
pageboy: pageboys
paisley: paisleys
palfrey: palfreys
palladium: palladiums
pallium: palliums
pancreatitis: pancreatitides
pandanus: pandanuses
pandemonium: pandemoniums
panfish: panfish
panjandrum: panjandrums
paperboy: paperboys
papilla: papillae
papooseroot: papooseroots
papovavirus: papovaviruses
pappus: pappuses
paramyxovirus: paramyxoviruses
parhelion: parhelia
parkway: parkways
parlay: parlays
parley: parleys
parotitis: parotitises
parrotfish: parrotfish
parsley: parsleys
parvis: parvises
parvovirus: parvoviruses
paspalum: paspalums
passageway: passageways
passerby: passersby
passkey: passkeys
pastis: pastises
paterfamilias: patresfamilias
pathway: pathways
patois: patois
patriarch: patriarchs
pavis: pavises
pay: pays
payday: paydays
pearlfish: pearlfish
peavey: peaveys
peccadillo: peccadilloes
pecopteris: pecopterises
pectoralis: pectoralises
pectus: pectuses
pel: peles
pelf: pelfs
peludo: peludoes
pelvis: pelvises
pemphigus: pemphiguses
pendulum: pendulums
penis: penises
penthouse: penthouses
penumbra: penumbrae
perch: perch
periapsis: periapsises
pericarditis: pericarditides
peridium: peridiums
perihelion: perihelia
periodontitis: periodontitises
peripatus: peripatuses
peritoneum: peritoneums
peritonitis: peritonitises
pernio: pernioes
person: people
persona: personae
pertussis: pertussises
pesthouse: pesthouses
petitio: petitioes
petrolatum: petrolatums
petroleum: petroleums
phaius: phaiuses
phalangitis: phalangitises
pharyngitis: pharyngitides
pharynx: pharynges
philadelphus: philadelphuses
phlebitis: phlebitides
phlomis: phlomises
phlox: phlox
phoney: phoneys
phosphorus: phosphoruses
pibroch: pibrochs
picornavirus: picornaviruses
pigfish: pigfish
pigman: pigmans
pikeperch: pikeperch
pilotfish: pilotfish
pilothouse: pilothouses
pinfish: pinfish
pinkroot: pinkroots
pintado: pintadoes
pipeclay: pipeclays
pipefish: pipefish
pirogi: pirogies
pisanosaurus: pisanosauruses
pitman: pitmans
pizzaz: pizzazzes
pizzicato: pizzicati
planetarium: planetariums
plasmodium: plasmodiums
platinum: platinums
platy: platys
platypus: platypuses
play: plays
playboy: playboys
playday: playdays
playhouse: playhouses
plectranthus: plectranthuses
plenum: plenums
plesiosaurus: plesiosauruses
pleura: pleurae
pleurothallis: pleurothallises
plexus: plexuses
plica: plicae
ploughboy: ploughboys
plowboy: plowboys
ploy: ploys
plum: plums
plus: pluses
plutonium: plutoniums
pneumonitis: pneumonitides
podium: podiums
pogey: pogeys
pokey: pokeys
polemonium: polemoniums
poliomyelitis: poliomyelitides
poliovirus: polioviruses
pollex: pollices
pollyfish: pollyfish
polonium: poloniums
polyanthus: polyanthuses
polymyositis: polymyositises
polyneuritis: polyneuritides
polypus: polypuses
pomatum: pomatums
poorboy: poorboys
poorhouse: poorhouses
popinjay: popinjays
porcupinefish: porcupinefish
porgy: porgy
porkfish: porkfish
poroporo: poroporoes
portcullis: portcullises
porterhouse: porterhouses
portico: porticoes
posseman: possemans
possum: possums
postcava: postcavae
posthitis: posthitises
potassium: potassiums
potato: potatoes
potboy: potboys
pothouse: pothouses
powerhouse: powerhouses
poxvirus: poxviruses
practicum: practicums
praesidium: praesidiums
praetorium: praetoriums
praseodymium: praseodymiums
precava: precavae
precious: preciouses
precis: precis
premium: premiums
pretorium: pretoriums
prey: preys
primordium: primordiums
proboscis: proboscises
proctitis: proctitises
prolapsus: prolapsuses
promethium: promethiums
pronunciamento: pronunciamentoes
proscenium: prosceniums
prosciuto: prosciutoes
prosciutto: prosciutti
prospectus: prospectuses
prostatitis: prostatitises
protactinium: protactiniums
protoactinium: protoactiniums
protoavis: protoavises
protohippus: protohippuses
protozoon: protozoa
pruritus: prurituses
psittacosaurus: psittacosauruses
psyllium: psylliums
pterygium: pterygiums
pubes: pubes
puddingwife: puddingwifes
pulley: pulleys
punkey: punkeys
pupa: pupae
purloo: purlooes
pus: puses
pussley: pussleys
pussyfoot: pussyfoots
puttyroot: puttyroots
pycnidium: pycnidiums
pyelonephritis: pyelonephritides
pythium: pythiums
quadrennium: quadrenniums
quarterstaff: quarterstaves
quay: quays
queenfish: queenfish
quietus: quietuses
quiz: quizzes
quorum: quorums
qwerty: qwertys
rabbitfish: rabbitfish
rabies: rabies
raceway: raceways
rachis: rachises
rachitis: rachitides
radium: radiums
railway: railways
raj: rajes
ray: rays
razmataz: razmatazzes
razorfish: razorfish
rebato: rebatoes
rebus: rebuses
rectum: rectums
redfish: redfish
redroot: redroots
referendum: referendums
regnellidium: regnellidiums
relatum: relatums
relay: relays
religious: religious
rendezvous: rendezvous
reovirus: reoviruses
replay: replays
resurvey: resurveys
reticulum: reticulums
retinitis: retinitides
retrovirus: retroviruses
revers: revers
rhabdovirus: rhabdoviruses
rhenium: rheniums
rhesus: rhesuses
rhinitis: rhinitides
rhinotracheitis: rhinotracheitises
rhizopus: rhizopuses
rhodium: rhodiums
rhombus: rhombuses
ribbonfish: ribbonfish
rickey: rickeys
rictus: rictuses
ridley: ridleys
rivulus: rivuluses
roadhouse: roadhouses
roadway: roadways
robolo: roboloes
rockfish: rockfish
rondeau: rondeaux
root: roots
ropeway: ropeways
rosebay: rosebays
rosefish: rosefish
rostrum: rostrums
rotavirus: rotaviruses
roughhouse: roughhouses
roundelay: roundelays
roundhouse: roundhouses
rubidium: rubidiums
ruckus: ruckuses
rudapithecus: rudapithecuses
rudderfish: rudderfish
rum: rums
rumpus: rumpuses
runaway: runaways
runway: runways
ruthenium: rutheniums
rutherfordium: rutherfordiums
sailfish: sailfish
saleratus: saleratuses
salesperson: salespeople
salmonella: salmonellae
salpiglossis: salpiglossises
salpingitis: salpingitises
saman: samans
samarium: samariums
sanatarium: sanatariums
sanatorium: sanatoriums
sanctum: sanctums
sandboy: sandboys
sandfish: sandfish
sandgrouse: sandgrouse
sandwichman: sandwichmans
sangapenum: sangapenums
sanitarium: sanitariums
sardius: sardiuses
sargassum: sargassums
sashay: sashays
saveloy: saveloys
savoy: savoys
sawbones: sawbones
sawfish: sawfish
say: says
scabious: scabiouses
scammonyroot: scammonyroots
scampo: scampi
scandium: scandiums
scapula: scapulae
scarabaeus: scarabaeuses
scarf: scarves
schema: schemata
schistorrhachis: schistorrhachises
schizanthus: schizanthuses
schmo: schmoes
schnapps: schnapps
schnaps: schnaps
schoolboy: schoolboys
schoolchild: schoolchildren
schoolhouse: schoolhouses
scleritis: scleritises
scolion: scolia
scolopendrium: scolopendriums
scoot: scoots
scoria: scoriae
scorpionfish: scorpionfish
scouse: scouses
screenplay: screenplays
scrum: scrums
scum: scums
seaway: seaways
sebum: sebums
sedum: sedums
selenium: seleniums
sequela: sequelae
serratus: serratuses
serum: serums
seta: setae
sgraffito: sgraffiti
shako: shakoes
shaman: shamans
shay: shays
shellfish: shellfish
shipway: shipways
shoot: shoots
showbiz: showbizzes
shrimpfish: shrimpfish
sialadenitis: sialadenitises
sickbay: sickbays
signore: signori
silverfish: silverfish
simulacrum: simulacrums
singultus: singultuses
sinopis: sinopises
sinus: sinuses
sinusitis: sinusitises
sis: sises
skilletfish: skilletfish
slaughterhouse: slaughterhouses
slavey: slaveys
slipway: slipways
sluiceway: sluiceways
slum: slums
smartypants: smartypants
smilo: smiloes
smokehouse: smokehouses
smooth: smooths
snailfish: snailfish
snakefish: snakefish
snakeroot: snakeroots
snipefish: snipefish
snoot: snoots
soapfish: soapfish
sodium: sodiums
soldierfish: soldierfish
soleus: soleuses
somniloquy: somniloquys
soot: soots
sooth: sooths
sordino: sordini
sorghum: sorghums
souse: souses
soy: soys
spadefish: spadefish
spadix: spadices
spathiphyllum: spathiphyllums
spearfish: spearfish
speculum: speculums
speedway: speedways
spermatozoon: spermatozoa
sphagnum: sphagnums
spillway: spillways
spinney: spinneys
splay: splays
splenitis: splenitises
spokesperson: spokespeople
spondylitis: spondylitises
spouse: spouses
spray: sprays
squama: squamae
squawroot: squawroots
squirrelfish: squirrelfish
stableboy: stableboys
stadium: stadiums
stairway: stairways
standby: standbys
starfish: starfish
status: statuses
staurikosaurus: staurikosauruses
stay: stays
steakhouse: steakhouses
steerageway: steerageways
stegosaurus: stegosauruses
stenopterygius: stenopterygiuses
stepchild: stepchildren
stephanotis: stephanotises
sternum: sternums
stingray: stingrays
stockfish: stockfish
stomach: stomachs
stomatitis: stomatitises
stonefish: stonefish
stoneroot: stoneroots
storehouse: storehouses
storey: storeys
stowaway: stowaways
strabismus: strabismuses
straightaway: straightaways
strawman: strawmans
stray: strays
streptocarpus: streptocarpuses
stria: striae
strife: strifes
stroma: stromata
strontium: strontiums
strophanthus: strophanthuses
strum: strums
struthiomimus: struthiomimuses
stucco: stuccoes
stumblebum: stumblebums
stylostixis: stylostixises
stylus: styluses
stypsis: stypsises
styracosaurus: styracosauruses
subconscious: subconsciouses
subgenus: subgenera
subhuman: subhumans
submaxilla: submaxillae
subspecies: subspecies
subway: subways
succubus: succubuses
succus: succusses
suckerfish: suckerfish
sugarloaf: sugarloaves
sugarplum: sugarplums
sum: sums
sumach: sumachs
summerhouse: summerhouses
sunfish: sunfish
sunray: sunrays
supercargo: supercargoes
supercilium: superciliums
superhero: superheroes
superhighway: superhighways
superhuman: superhumans
superphylum: superphylums
surffish: surffish
surfperch: surfperch
surgeonfish: surgeonfish
surplus: surpluses
surrey: surreys
survey: surveys
sway: sways
swiz: swizzes
swordfish: swordfish
swordplay: swordplays
syconium: syconiums
syllabus: syllabuses
symposium: symposiums
synch: synchs
syncytium: syncytiums
synechia: synechiae
synovitis: synovitises
syphilis: syphilises
tableau: tableaux
talcum: talcums
talisman: talismans
tallboy: tallboys
tamarindo: tamarindoes
tannoy: tannoys
tantalum: tantalums
tantrum: tantrums
taphouse: taphouses
tapis: tapises
taproot: taproots
tarsitis: tarsitises
tatouay: tatouays
taxiway: taxiways
teahouse: teahouses
tearaway: tearaways
tech: techs
technetium: technetiums
tedium: tediums
teetotum: teetotums
tellurium: telluriums
tenderfoot: tenderfoots
tendinitis: tendinitises
tendonitis: tendonitises
tennis: tennises
tenosynovitis: tenosynovitises
tentorium: tentoriums
terbium: terbiums
terrarium: terrariums
testatrix: testatrices
tetanus: tetanuses
thallium: thalliums
thallus: thalluses
theca: thecae
thesaurus: thesauruses
they: theys
thief: thieves
thiobacillus: thiobacilluses
this: thises
thorium: thoriums
threadfish: threadfish
thrombophlebitis: thrombophlebitides
throughway: throughways
throwaway: throwaways
thrum: thrums
thruway: thruways
thulium: thuliums
thyrsopteris: thyrsopterises
thyself: thyselfs
tibia: tibiae
tibialis: tibialises
ticktacktoo: ticktacktooes
tideway: tideways
tilefish: tilefish
tinnitus: tinnituses
titanium: titaniums
toadfish: toadfish
today: todays
togavirus: togaviruses
tolbooth: tolbooths
tollbooth: tollbooths
tollhouse: tollhouses
tollway: tollways
tomalley: tomalleys
tomatillo: tomatilloes
tomato: tomatoes
tomboy: tomboys
tonguefish: tonguefish
tonsillitis: tonsillitises
tonus: tonuses
toot: toots
tornado: tornadoes
torpedo: torpedoes
torticollis: torticollises
tourney: tourneys
townhouse: townhouses
toy: toys
trachea: tracheae
tracheitis: tracheitises
trad: trades
tramway: tramways
transversalis: transversalises
transversus: transversuses
trapezium: trapeziums
tray: trays
trellis: trellises
trey: treys
triceps: triceps
triceratops: triceratops
trichina: trichinae
trichodesmium: trichodesmiums
triggerfish: triggerfish
trillium: trilliums
triptych: triptychs
tritium: tritiums
trochlearis: trochlearises
trolley: trolleys
trolleybus: trolleybuses
trompillo: trompilloes
trousseau: trousseaux
trumpetfish: trumpetfish
trunkfish: trunkfish
tuba: tubae
tubeless: tubeless
tum: tums
tumulus: tumuluses
tunica: tunicae
turakoo: turakooes
turnkey: turnkeys
tympanum: tympanums
typhus: typhuses
tyrannosaurus: tyrannosauruses
ulitis: ulitises
ulna: ulnae
ultimatum: ultimatums
unconscious: unconsciouses
underlay: underlays
unnilhexium: unnilhexiums
unnilpentium: unnilpentiums
unnilquadium: unnilquadiums
unnilquintium: unnilquintiums
unnilseptium: unnilseptiums
unperson: unpeople
uranium: uraniums
urarthritis: urarthritises
ureteritis: ureteritises
urethra: urethrae
urethritis: urethritises
uropygium: uropygiums
urus: uruses
uveitis: uveitises
uvulitis: uvulitises
vacuum: vacuums
vagina: vaginae
vaginitis: vaginitides
valley: valleys
valvulitis: valvulitises
vanadium: vanadiums
variorum: variorums
vasculitis: vasculitides
veejay: veejays
veg: veges
vellum: vellums
vena: venae
verdigris: verdigrises
verruca: verrucae
vertebra: vertebrae
verticillium: verticilliums
vertigo: vertigoes
vesica: vesicae
vesiculitis: vesiculitises
veto: vetoes
viaticus: viaticuses
vibrissa: vibrissae
viceroy: viceroys
virago: viragoes
virus: viruses
viscus: viscera
vita: vitae
vivarium: vivariums
volcano: volcanoes
volley: volleys
vomitus: vomituses
vulva: vulvae
vulvitis: vulvitises
waitperson: waitpeople
walkaway: walkaways
walkway: walkways
walrus: walruses
wampum: wampums
warehouse: warehouses
washday: washdays
washhouse: washhouses
watercolous: watercolouses
waterleaf: waterleafs
waterway: waterways
way: ways
weakfish: weakfish
weekday: weekdays
wharf: wharves
whatsis: whatsises
wheelhouse: wheelhouses
whereabouts: whereabouts
whey: wheys
whimsey: whimseys
whiskey: whiskeys
whitefish: whitefish
whitey: whiteys
whiz: whizzes
whorehouse: whorehouses
whoso: whosoes
why: whys
widowman: widowmans
wildlife: wildlifes
wincey: winceys
wiz: wizzes
wolffish: wolffish
wolfman: wolfmans
woodlouse: woodlouses
wordplay: wordplays
workday: workdays
workhouse: workhouses
wormfish: wormfish
wreckfish: wreckfish
xeranthemum: xeranthemums
yesterday: yesterdays
yobbo: yobboes
yobo: yoboes
ytterbium: ytterbiums
yttrium: yttriums
zaman: zamans
zirconium: zirconiums
