anopheles: anopheles
bacchanalia: bacchanalia
cyclops: cyclops
ficus: ficus
fredericton: fredericton
hertz: hertz
ireland: ireland
lox: lox
nairobi: nairobi
narcissus: narcissus
pekinese: pekinese
pekingese: pekingese
pomacanthus: pomacanthus
ptloris: ptloris
salmon: salmon
seeland: seeland
wheeling: wheeling
ageratum: ageratum
aircraft: aircraft
albacore: albacore
albatross: albatross
alligatorfish: alligatorfish
amberfish: amberfish
angelfish: angelfish
anglerfish: anglerfish
antelope: antelope
antiaircraft: antiaircraft
appalling: appalling
archerfish: archerfish
balloonfish: balloonfish
barrelfish: barrelfish
batfish: batfish
baud: baud
belling: belling
betrothed: betrothed
biceps: biceps
billfish: billfish
bison: bison
blackfish: blackfish
blowfish: blowfish
boarfish: boarfish
bonefish: bonefish
bourgeois: bourgeois
bowling: bowling
boxfish: boxfish
brisling: brisling
buffalofish: buffalofish
bundling: bundling
burrfish: burrfish
butterfish: butterfish
butterflyfish: butterflyfish
buttonquail: buttonquail
cardinalfish: cardinalfish
caribou: caribou
carp: carp
castling: castling
catfish: catfish
catling: catling
chamois: chamois
changeling: changeling
chassis: chassis
chub: chub
cigarfish: cigarfish
clingfish: clingfish
cobbling: cobbling
cod: cod
codfish: codfish
codling: codling
coho: coho
conchfish: conchfish
contretemps: contretemps
controlling: controlling
convictfish: convictfish
cooling: cooling
cornetfish: cornetfish
corps: corps
coupling: coupling
cowfish: cowfish
cowling: cowling
crackling: crackling
crampfish: crampfish
crappie: crappie
crawfish: crawfish
crawling: crawling
crayfish: crayfish
curdling: curdling
curling: curling
cutlassfish: cutlassfish
cuttlefish: cuttlefish
dace: dace
damselfish: damselfish
dangling: dangling
dead: dead
dealfish: dealfish
debris: debris
deer: deer
detritus: detritus
devilfish: devilfish
diabetes: diabetes
doctorfish: doctorfish
doe: doe
dollarfish: dollarfish
dolphinfish: dolphinfish
dong: dong
driftfish: driftfish
drumfish: drumfish
duckling: duckling
dumpling: dumpling
earthling: earthling
eggshake: eggshake
eland: eland
elect: elect
endocarp: endocarp
expelling: expelling
feeling: feeling
filefish: filefish
filling: filling
fingerling: fingerling
firstborn: firstborn
fish: fish
flagfish: flagfish
flak: flak
flamefish: flamefish
flatfish: flatfish
fledgeling: fledgeling
flounder: flounder
fondling: fondling
footling: footling
forceps: forceps
foreland: foreland
forestalling: forestalling
foundling: foundling
fowl: fowl
frogfish: frogfish
frosh: frosh
fry: fry
fuzz: fuzz
gallows: gallows
gambling: gambling
garfish: garfish
geisha: geisha
ghostfish: ghostfish
gigahertz: gigahertz
globefish: globefish
gnu: gnu
goatfish: goatfish
goldfish: goldfish
goosefish: goosefish
gosling: gosling
grand: grand
greenling: greenling
gross: gross
groundfish: groundfish
groundling: groundling
grouse: grouse
growling: growling
grueling: grueling
gruelling: gruelling
guitarfish: guitarfish
guttersnipe: guttersnipe
hagfish: hagfish
haiku: haiku
hake: hake
halibut: halibut
handling: handling
handshake: handshake
harvestfish: harvestfish
hatchling: hatchling
headfish: headfish
headshake: headshake
heathfowl: heathfowl
heckling: heckling
herring: herring
hireling: hireling
hogfish: hogfish
homefolk: homefolk
homeless: homeless
horsefish: horsefish
horseflesh: horseflesh
horsepower: horsepower
hovercraft: hovercraft
howling: howling
ibex: ibex
ibis: ibis
idling: idling
impatiens: impatiens
inkling: inkling
installing: installing
instilling: instilling
jacksnipe: jacksnipe
jawfish: jawfish
jellyfish: jellyfish
jewfish: jewfish
jobless: jobless
kilohertz: kilohertz
kin: kin
kindling: kindling
kingfish: kingfish
kip: kip
kneeling: kneeling
kuchen: kuchen
lacteal: lacteal
ladyfish: ladyfish
lancetfish: lancetfish
lanternfish: lanternfish
leatherfish: leatherfish
less: less
leveling: leveling
ling: ling
linguine: linguine
linguini: linguini
lionfish: lionfish
lizardfish: lizardfish
lobster: lobster
lumpfish: lumpfish
lynx: lynx
mackerel: mackerel
marlin: marlin
mayfish: mayfish
megahertz: megahertz
menhaden: menhaden
microfiche: microfiche
military: military
milkshake: milkshake
milling: milling
mingling: mingling
miniseries: miniseries
mink: mink
modeling: modeling
modelling: modelling
monkfish: monkfish
monocarp: monocarp
moonfish: moonfish
moorfowl: moorfowl
moose: moose
mosquitofish: mosquitofish
mottling: mottling
muskellunge: muskellunge
muttonfish: muttonfish
neat: neat
needlefish: needlefish
nestling: nestling
nisei: nisei
numbfish: numbfish
nurseling: nurseling
nursling: nursling
oarfish: oarfish
offspring: offspring
oilfish: oilfish
oysterfish: oysterfish
paddlefish: paddlefish
paneling: paneling
panelling: panelling
panfish: panfish
parcelling: parcelling
parrotfish: parrotfish
patois: patois
patrolling: patrolling
pealing: pealing
pearlfish: pearlfish
peeling: peeling
perch: perch
pericarp: pericarp
phlox: phlox
pickerel: pickerel
pigfish: pigfish
pikeperch: pikeperch
pilotfish: pilotfish
pinfish: pinfish
pinyin: pinyin
pipefish: pipefish
piranha: piranha
poi: poi
police: police
pollack: pollack
polling: polling
pollock: pollock
pollyfish: pollyfish
pompano: pompano
porcupinefish: porcupinefish
porgy: porgy
porkfish: porkfish
porpoise: porpoise
precis: precis
prickling: prickling
pseudocarp: pseudocarp
ptarmigan: ptarmigan
pubes: pubes
pulling: pulling
quail: quail
queenfish: queenfish
quid: quid
rabbitfish: rabbitfish
rabies: rabies
railing: railing
rangeland: rangeland
raveling: raveling
ravelling: ravelling
razorfish: razorfish
redfish: redfish
reindeer: reindeer
religious: religious
rendezvous: rendezvous
repelling: repelling
revers: revers
ribbonfish: ribbonfish
ridgeling: ridgeling
rifling: rifling
rigatoni: rigatoni
rockfish: rockfish
roe: roe
rosefish: rosefish
rudderfish: rudderfish
rustling: rustling
sable: sable
sailfish: sailfish
sailing: sailing
sampling: sampling
samurai: samurai
sanderling: sanderling
sandfish: sandfish
sandgrouse: sandgrouse
sapling: sapling
sawbones: sawbones
sawfish: sawfish
scampi: scampi
scantling: scantling
schnapps: schnapps
schnaps: schnaps
schrod: schrod
scorpionfish: scorpionfish
scrod: scrod
sculling: sculling
seafowl: seafowl
sealing: sealing
seedling: seedling
selling: selling
seraphim: seraphim
settling: settling
shad: shad
sheep: sheep
shellfish: shellfish
shrimp: shrimp
shrimpfish: shrimpfish
sibling: sibling
silverfish: silverfish
sixpence: sixpence
skilletfish: skilletfish
smartypants: smartypants
snailfish: snailfish
snakefish: snakefish
snipe: snipe
snipefish: snipefish
soapfish: soapfish
soldierfish: soldierfish
sole: sole
spadefish: spadefish
sparkling: sparkling
sparling: sparling
spearfish: spearfish
springbok: springbok
squab: squab
squid: squid
squirrelfish: squirrelfish
stabling: stabling
starfish: starfish
starling: starling
starveling: starveling
stockfish: stockfish
stonefish: stonefish
strangling: strangling
stripling: stripling
sturgeon: sturgeon
subspecies: subspecies
suckerfish: suckerfish
suckling: suckling
sunfish: sunfish
surffish: surffish
surfperch: surfperch
surgeonfish: surgeonfish
swine: swine
swordfish: swordfish
syncarp: syncarp
tackling: tackling
tailing: tailing
tarpon: tarpon
tatami: tatami
teal: teal
telling: telling
threadfish: threadfish
threepence: threepence
tickling: tickling
tideland: tideland
tilefish: tilefish
tilling: tilling
timpani: timpani
tingling: tingling
toadfish: toadfish
tonguefish: tonguefish
towelling: towelling
townsfolk: townsfolk
trampling: trampling
traveling: traveling
travelling: travelling
triceps: triceps
triceratops: triceratops
triggerfish: triggerfish
tripling: tripling
trivia: trivia
trout: trout
truckling: truckling
trumpetfish: trumpetfish
trunkfish: trunkfish
tubeless: tubeless
tuna: tuna
twinkling: twinkling
twopence: twopence
tympani: tympani
underling: underling
vermicelli: vermicelli
vermin: vermin
vetchling: vetchling
walleye: walleye
wangling: wangling
wasteland: wasteland
watercannon: watercannon
watercraft: watercraft
waterfowl: waterfowl
weakfish: weakfish
weakling: weakling
whaling: whaling
whereabouts: whereabouts
whirling: whirling
whistling: whistling
whitefish: whitefish
wildfowl: wildfowl
wolffish: wolffish
won: won
wormfish: wormfish
wrangling: wrangling
wreckfish: wreckfish
wrestling: wrestling
yearling: yearling
yodeling: yodeling
young: young
yowling: yowling
yuan: yuan
